hæ	h @
mær	" m {: r
dæm	" d E m
tånn	" t O n
dæ	"" d e:
vårres	"" v o: r $ r e: s
tøre	"" t 2: $ r @
dånn	"" d o: n
wæ	" v e:
mått	"" m O t
dåkker	"" d O $ k @ r
kjæm	"" C E m
åja	"" o: $ j A
nåkka	"" n O $ k A
brøskiva	"" b r 2: $ % S i: $ v A
æh	" {:
ååå	"" O O o:
hjælp	"" j E l p
åh	"" o:
åååå	"" O O O o:
brøskiv	" b r 9 $ S i: v
åsså	"" o: $ % s o:
wææææ	" v e: @ @ e:
mælk	" m {: l k
årne	"" o: $ n` @
næmmen	"" n {: $ % m E n
ævå	e: v o:
bæsse	" b E $ s @
tåran	"" t o: $ r A n
bæstemor	"" b E $ s t @ $ % m u: r
puslespælle	"" p u0 $ s l @ $ % s p E l
brø	" b r 2:
øran	" 2: $ r A n
tlæ	t @ $ l @
værsego	"" v {: r $ s e: $ g U
tyholttårne	" t y: $ % h O l $ t o: $ n` @
brøskive	"" b r 2: $ % S i: $ v @
æææ	" n {: @ e:
æda	e: $ d A
bortpå	" b U t` $ % p o:
ånei	% O n {*I
færdi	" f { $ d` I
ååååå	"" O O O O o:
tannbørstn	"" t A n $ % b 9 $ s` t n=
åkkå	"" O $ k o:
blønen	"" b l 2: $ n n=
fær	"" f {: r
lægo	"" l e: $ g U
dåkkers	"" d O $ k @ s`
bløteple	"" b l 2: t $ % E $ p l @
kæm	"" C E m
læke	"" l {: $ k @
åpn	% o: p $ n
øh	" 2:
æææææ	" n {: @ @ @ e:
mummibæsj	" m u0 $ m I $ " b E S
wææ	" v e: e:
døtt	"" d 9 t
puslespæll	"" p u0 $ s l @ $ % s p E l
blæs	" b l e: s
lørdagsgodt	" l 2: $ d` A: g s $ % g U t
wæææ	" v e: @ e:
blåen	"" b l o: $ @ n
brødskiv	"" b r 2: $ % S i: v
ødla	" 9 d $ l A
bæbi	" b {: $ b I
åå	"" O o:
søv	"" s 9 v
hårstrikk	"" h o: r $ % s t r I k
sånnen	"" s O $ n n=
bæssemor	"" b E $ s @ $ % m u: r
hjæp	"" j e: p
sjåån	S O $ " O n
månetin	"" m o: $ n @ $ t I n
bæbu	" b {: $ % b }:
støvla	"" s t 9 v $ l A
påsketing	"" p o: $ s k @ $ % t I N
dørr	"" d 9 r
wæææææ	" v e: @ @ @ e:
jæ	" j e:
gråtass	"" g r o: $ % t A s
øøøø	" 2: $ 2: $ 2: $ % 2:
ææææ	" n {: @ @ e:
lørdagodt	" l 2: $ d` A: $ g O t
kjøkkene	" C 9 $ k @ $ n @
bæbæ	" b e: $ b @
æhæhæ	" {: e: e:
ættepå	% E $ t @ $ % p o:
blåfugl	"" b l o: $ % f }: l
ææææææ	" n {: @ @ @ @ e:
møøøø	" m 2: $ 2: $ 2: $ % 2:
bæda	" b {: $ d A
ænn	E n
åkern	% o: $ k @ n`
dårli	"" d o: $ % l` i:
fæm	"" f {: $ " E m
æm	" n {: $ @ m
årna	"" o: $ n` A
møøø	" m 2: $ 2: $ % 2:
bæbubæbubæbu	" b {: $ b }: $ % b E b 9 b e: $ % b }:
nissegrøt	"" n I $ s @ $ % g r 2: t
hæhæ	"" h {: e:
pulebrø	"" p }: $ l @ $ b r 2:
pætefinger	"" p {: t $ f I N $ @ r
våkenvåkenvåken	"" v o: $ k @ n $ % v o: $ k @ n $ % v o: $ k @ n
eliasbåte	E $ " l i: $ A s $ % b o: $ t @
læse	l @ $ s @
bæste	"" b E $ s t @
fårke	" f o: r $ k @
hjæmme	"" j E $ m @
æhm	" {: m
vertøy	"" v E $ % t` 9*Y
verktøyan	"" v { r k $ t 9*Y $ A n
fånn	"" f O n
snøballa	"" s n 2: $ % b A $ l A
enebærbusk	"" e: $ n @ $ b {: r $ % b u0 s k
bæby	" b {: $ % b y:
køre	" k 2: $ r @
årstlikk	% O s` t` $ l I k
klissebløtt	"" k l I $ s @ $ % b l 9 t
døre	"" d 2: $ r @
røød	"" r 2: $ % 2: d
jorbær	"" j u: r $ % b {: r
juletræet	"" j }: $ l @ $ % t r {: $ @
æææsj	" n {: @ E S
bøkern	"" b 2: $ k @ n`
båtn	"" b o: t $ n=
bbæssemor	% b e: $ b @ s $ % m u: r
nånn	"" n O n
kråkeklubben	"" k r o: $ k @ $ % k l u0 $ b @ n
æppeljus	" n {: $ p l= $ j u0 s
bøøøø	" b 2: $ 2: $ 2: $ % 2:
helsesøstra	"" h E l $ s @ $ % s 9 $ s t r A
færd	" f { d`
blåla	"" b l o: $ l A
bortapå	"" b U $ t` A $ % p o:
ingebær	" I N $ @ $ % b {: r
uæuæuæ	u0 $ @ @ e:
bæppep	" b {: $ % p e: p
pår	" p o: r
neppå	"" n e: p $ % p o:
hårstrikket	"" h o: r $ % s t r I $ k @ t
sånner	"" s O $ n @ r
hællo	" h E $ l U
læk	l @ k
vinterstøvlan	"" v I n $ t @ r $ % s t 2: v $ l A n
ååh	"" O o:
hjæm	"" j E m
hjælpe	"" j E l $ p @
ænebærbuss	" n {: $ n @ $ b {: r $ % b u0 s
vinterstøvla	"" v I n $ t @ r $ % s t 2: v $ l A
rosablå	" r u: $ s A $ % b l o:
skitåt	" S i: $ % t o: t
barnespråksgrammatikk	"" b A: $ n` @ $ % s p r o: k s $ g r A $ m A $ % t I k
spælle	"" s p {: l $ l @
tæi	" t {: $ I
æsjebæsj	E $ S @ $ b E S
bobababøbø	" b u: $ b A $ b A $ b 2: $ % b 2:
dæmmers	" d E $ m @ s`
bæbubæbu	" b {: $ b }: $ % b e: $ % b }:
bæssbæssemor	" b E s $ b @ s $ % m u: r
røbrus	" r 2: $ % b r }: s
bædabæda	" b {: $ d A: $ b @ $ d A
dått	" d o: t
æsel	@ $ s l=
vårra	"" v o: r $ r A
bææ	" b E e:
næ	"" n e:
æhæ	" {: e:
grrrrraaaa	" g r $ r O O
kjøttbolla	"" C 9 t $ % b O $ l A
nnnnenennnnn	" n $ n= $ @ n $ n
levertei	" l e: $ v @ $ % t` {*I
wæææo	" v e: @ @ U
gæ	" g e:
bøttan	"" b 9 $ t A n
litnpupp	l I $ t e: $ E n $ " p u0 p
appelsinjustørk	A $ p @ l $ " s i: n $ % j }: s $ % t 9 r k
katlabos	" k A t $ l A $ % b u: s
barnehageavdelinga	"" b A: $ n` @ $ h A: $ g @ $ A v $ % d e: $ l I N $ A
dududubombom	"" d u0 $ d u0 $ d u0 $ % b U m $ b U m
nææææ	"" n E @ @ e:
skumappelsinjuice	"" s k U m $ A $ p @ l $ " s i: n $ % j }: s
ehamomo	% e: $ h @ m u: $ m o:
ellaella	"" E $ l A $ " E $ l A
bokabokaboka	"" b u: k $ A $ b U $ k A $ % b u: $ k A
grøtn	"" g r 2: t $ n=
fiiir	"" f i: i: r
ææææææææ	" n {: @ @ @ @ @ @ e:
sukkasuk	"" s u0 $ k A $ s Y k
snøn	" s n 2: n
megangmege	" m e: $ g A N $ % m {*I
drdrdr	% d e: $ { r $ d e: $ { r $ d e: $ " { r
tæ	" t e:
tulipana	t u0 $ l I $ " p A: $ n A
idebelebåååå	I $ " d e: $ % b E $ l @ $ b O O O o:
lydelydelydelyda	"" l y: d $ % E l A*I d l A*I d E % l y: $ d A
dusjikke	"" d u0 $ S I $ k @
gråtrolle	"" g r o: t $ % r O $ l @
menemene	m @ $ " n e: $ m @ $ n @
påskekyllinger	"" p o: $ s k @ $ % C Y $ l I N $ @ r
glønne	"" g l 9 $ n @
lækebil	"" l {: $ k @ $ % b i: l
åkk	"" O k
løvan	"" l 2: $ % v A n
bobobob	" b u: $ b U b O b
bollebollebolle	"" b O $ l @ $ % b O $ l @ $ % b O $ l @
hårbørsta	"" h o: r $ % b 9 $ s` t` A
eeeeeewwwwæææææ	" e: e: e: $ % v e: $ v e: $ v e: $ " v e: @ @ @ e:
bssssswo	% b e: $ @ s $ @ s $ @ s $ @ s $ @ s $ " v U
kræsja	"" k r E $ S A
sageborde	"" s A: $ g @ $ b O $ d` @
kattebrus	"" k A $ t @ $ % b r }: s
børstebørstebørst	"" b 9 $ s` t` @ $ % b 2: $ s` t` @ $ b 9 s` t
laaaalala	" l A: O A: $ l A
nænamanam	"" n {: $ n A $ m A $ % n A m
pappappapppa	"" p A $ p A $ % p A p $ p A
bb-b-biola	" b $ % b e: $ b I $ " u: $ l A
dingdingdingding	"" d I N $ d I N $ d I N $ d I N
bareblabla	"" b A: $ r @ $ b l A: $ b l A
vofffloffloff	"" v O f $ f l U f l U f
lillebjørn	"" l I $ l @ $ % b j 2: n`
næmmenæmennono	"" n {: $ % m E n e: $ m @ $ n U $ n U
klampebil	"" k l A m $ p @ $ % b i: l
nanadetdet	n A $ n A $ " d E t $ d @
sækk	"" s E $ k
lobbedeiloppedei	"" l O $ b @ $ " d {*I $ l U $ p @ $ " d {*I
kattefjell	"" k A $ t @ $ % f j E l
sklieplassn	"" s k l i: $ @ $ p l A $ % s n
malegensern	m A $ l @ $ " S A N $ " s {: n`
mæmæmæ	"" m e: $ % m E m e:
haraldpute	"" h A $ r A l $ p }: $ t @
enenen	E n $ "" e: $ n n=
bøskiva	" b 2: $ % S i: $ v A
maaaam	" m o: $ % o: $ m
blålyse	"" b l o: $ % l y: $ s @
tloll	t @ $ l O l
belebleb	b @ $ " l e: $ b l @ b
gurrot	"" g }: r $ % r u: t
lelele	" l e: l l=
loffatorskloffaloffatorsk	"" l U $ f A $ t U s` $ k l U $ f A l U f $ A $ % t O s` k
ingriboka	"" I N $ % r i: $ % b u: $ k A
hadehade	" h A: $ d @ $ h A: $ d @
mømømømømømø	" m 9 $ m 9 $ m 9 $ m 9 $ m 9 $ m 9
elelelel	E $ l @ k $ l l= l
brokkolibrokkoli	" b r O $ k O $ l I $ " b r O $ k O $ l I
stilletrille	"" s t I $ l @ $ % t r I $ l @
ratatatata	" r A $ t A $ % t A: $ % t A: $ t A
loffaloffaloff	"" l U $ f A l U $ f A l U f
laksetorsk	"" l A k $ s @ $ % t O s` k
taleblett	"" t A: $ l @ $ % b l E t
vovovovovo	"" v O $ v U $ v U $ v U $ v U
tedele	" t e: $ % d e: $ l @
mimimimi	m I $ "" m i: $ m I $ m I
bursdagspannekake	" b u0 s` $ d` A: g s $ p A $ n @ $ % k A: $ k @
bollong	"" b O $ l O N
bestehet	"" b E $ s t @ $ % h e: t
kalalyptus	k A $ l A $ " l Y p $ t u0 s
bikkebaka	"" b I $ k @ $ b A: $ k A
storbit	"" s t u: r $ % b i: t
æddabædda	E $ d A b E $ d A
bibibibibibib	b I $ b I $ b I $ b I $ b I $ " b i: b
fomlefomle	"" f U m $ l @ $ " f U m $ l @
petterkopp	" p E $ t @ r $ % k O p
borteburken	"" b U $ t` @ $ b u0 r $ k @ n
båta	"" b o: $ t A
krokodillematpakke	k r U $ k U $ "" d I $ l @ $ m A: t $ % p A $ k @
nokkaboka	"" n O $ k A $ % b u: $ k A
hmhmhmhm	% h o: $ E m $ " m m
gggrrrr	" g $ g r r
bolllebolle	"" b O $ l @ l $ % b O $ l @
jaaaaha	" j A: O A
brøfugl	"" b r 2: $ % f }: l
bababababba	" b A: $ b A $ b A $ " b A $ b A
malebuksa	"" m A: $ l @ $ % b U k $ s A
bedebedebede	b @ $ " d E $ b @ $ "" d e: $ b @ $ d @
isekonduktur	"" i: $ s @ $ k U n $ d u0 k $ " t }: r
nekkern	"" n E $ k @ n`
bleble	"" b l e: $ b l @
olelagt	"" u: $ l @ $ % l A k t
årner	"" o: $ n` @ r
appelsinmarka	A $ p @ l $ " s i: n $ m A r $ k A
hemhem	"" h E m $ h @ m
dædædædædææ	"" d {: $ d {: d {: d {: d {: e:
dingdongdingdong	"" d I N $ " d O N $ d I N $ " d O N
bededete	b @ $ " d E $ d @ $ t @
tissebanen	"" t I $ s @ $ % b A: $ n n=
ehmhmh	% e: $ h o: $ E m $ " h o: $ E m $ " h o:
patbok	" p A t $ % b u: k
tykla	"" t Y $ k l A
bænt	" b E n t
rissrissriss	" r I s $ % r I s $ % r I s
festmålti	" f E s t $ m o: l $ % t i:
framten	" f r A m $ t n=
påleggbil	"" p o: $ l @ g $ % b i: l
matost	"" m A: t $ % U s t
lørdaggodt	" l 2: $ d` A g $ % g O t
brøgul	"" b r 2: $ % g }: l
hårstikk	"" h o: r $ % s t I k
manemane	m A $ " n e: $ m A $ n @
snømannlykt	"" s n 2: $ % m A n s $ % l Y k t
mekalamalame	m @ $ k A $ l A $ m A $ " l A: $ m @
måneti	"" m o: $ n @ $ t I
appeljus	A $ p @ l $ j u0 s
isjisjisj	" I $ S I $ S I S
termerke	t @ r $ " m { r $ k @
akkebått	"" A $ k @ $ b O t
ballballballball	" b A l $ b A l $ b A l $ b A l
nomenomenomnamenom	n U $ m @ $ n U $ m @ $ n U m $ n A $ m @ $ " n u: m
geitebukka	"" j {*I $ t @ $ % b U $ k A
dsssssssææææ	" d $ % s` s $ " s {: @ @ e:
booooo	" b }: u0 $ U
årmen	% o: r $ m @ n
tegnebrilla	"" t {*I $ n @ $ % b r I $ l A
åjo	"" o: $ j U
kebil	" k e: $ % b i: l
lydelyde	"" l y: $ d @ $ % l y: $ d @
kometkamerutene	k U $ " m e: t $ k A $ m @ $ % r }: $ t n= $ @
tælle	"" t E l
dutututu	d Y $ " t y: t Y $ " t y:
hikkehikke	"" h I $ k @ $ h I $ k @
bakebakebokaboka	"" b A: $ k @ $ % b A: $ k @ $ b u: k $ A $ % b u: $ k A
lydelydelyde	"" l y: d $ % E l A*I d $ % l y: $ d @
lydilydilid	" l y: $ d I $ " l y: $ d I $ % l i:
bolsebolse	"" b O l $ s @ $ b O l $ s @
duliattndei	"" d u0 l $ j A t $ n {*I
lillefin	"" l I $ l @ $ % f i: n
øøøh	" 2: $ 2: $ 2:
slæpp	"" s` l e: p
mmmmmmbleeeeee	" m $ m m r I e: i:
artidokk	A $ t` I $ " d O k
sparekua	"" s p A: $ r @ $ % k }: $ A
nønønønø	" n 9 $ n 9 $ n 9 $ % n 2:
prestn	"" p r E s t $ n=
næææ	"" n E @ e:
apekattejoggert	"" A: $ p @ $ % k A $ t @ $ % j O $ g @ t`
røykvarslern	"" r 9*Y k $ % v A $ s` l @ n`
booooi	" b }: u0 $ I
værego	"" v {: $ r @ $ g U
guttebassn	"" g u0 $ t @ $ b A $ % s n
bussjåførn	" b u0 s $ S O $ % f 2: n`
dumpedokkdumpedokk	"" d U m $ p @ $ % d O k $ d U m $ p @ $ % d O k
badabogga	b A $ d A $ " b O $ g A
æg	@ g
fæææær	"" f {: $ " n {: @ {: r
nuuuuuuu	" n }: }: }:
munnennananana	"" m u0 $ n n= $ n A $ n A $ " n A: $ n A
bærtbært	" b {: t` $ % b {: t`
japeja	j A $ " p E $ j A
uuuuuubæbubæbu	% }: $ }: $ " }: }: b {: $ b }: $ % b e: $ % b }:
bøøøøø	" b 2: $ 2: $ 2: $ 2: $ % 2:
håååå	h O $ " O O o:
tækk	"" t E $ k
bussjåføørn	" b u0 s $ S O $ % f 2: $ % 2: n`
jatejate	j A $ t @ $ " j A: $ t @
nateppe	"" n A $ % t E $ p @
æddaædda	E $ d A: E $ d A
loffaloffaloffa	"" l U $ f A l U $ f A l U $ f A
epledyltetøy	"" E $ p l @ $ % d Y l $ t @ $ % t 9*Y
bamsemum	"" b A m $ s @ $ m u0 m
nananna	n A $ " n A $ n A
darara	d A $ " r A: $ r A
bøbe	"" b 9 $ b @
knekkebrø	"" k n E $ k @ $ % b r 2:
hæææææ	" h E @ @ @ e:
åsse	"" O s
mummitloll	" m u0 $ m I t $ % l O l
bløn	"" b l 2: n
hooohooo	" h u0 $ u: $ " h u0 $ U
bøøø	" b 2: $ % 9 2:
dinokompis	" d i: $ n U $ k U m $ p I s
wææææææææ	" v e: @ @ @ @ @ @ e:
bieee	b I $ " e:
sandkass	"" s A N $ % k A s
ædabædabæda	e: $ d A: $ b @ $ d A: $ b @ $ d A
apeka	"" A: $ p @ $ % k A
doppedak	"" d O $ p @ $ d A k
dadadadada	d A $ d A $ d A $ " d A: $ d A
bopop	" b u: $ % p O p
tlus	t @ $ l u0 s
tæsstn	"" t E $ s t n=
røteppe	"" r 2: $ % t E $ p @
tæbetisj	" t e: $ % b e: $ t I S
ågjøre	"" o: $ j 2: $ r @
hårstrikkemat	"" h o: r $ % s t r I $ k @ $ % m A: t
dæffor	" d E $ f O r
allgul	"" A l $ % g }: l
bababababa	" b A: $ b A $ b A $ " b A: $ b A
tralalei	"" t r A: $ l A $ % l {*I
åååh	"" O O o:
kotletta	" k O t $ % l E $ t A
dopperak	"" d O $ p @ $ % r A k
pyrstikka	p Y $ % s` t I $ k A
terass	t @ $ " r A s
øø	" 2: 2:
dempevarm	"" d E m $ p @ $ % v A r m
åj	"" O
dalink	d A $ l I N k
disdisids	" d i: s $ d I $ % s i: s
neieneieneienei	"" n {*I $ @ n {*I $ @ n {*I $ @ $ % n {*I
appeldinjus	A $ p @ l $ % d i: n $ j u0 s
kakaha	k A $ k A $ " h A:
blåbærkake	" b l o: $ b {: r $ % k A: $ k @
bobowæææ	" b u: $ b O v e: @ e:
rorider	r O $ " r i: $ d @ r
tutttitu	"" t U $ % t i: $ t u0
juletræ	"" j }: $ l @ $ % t r e:
storesøst	"" s t u: $ r @ $ % s 9 s t
væresgo	"" v {: $ r @ s $ g O
jordbærsupp	" j U r $ b {: r $ s u0 p
booobutbuta	b u0 $ O b $ }: t $ b u0 $ % t A:
pufle	"" p }: $ f l @
splissesplisse	" s p l I $ " s E $ s p l I $ s @
æææææææææ	" n {: @ @ @ @ @ @ @ e:
grisebie	"" g r i: $ s @ $ % b I
ølakt	" v 9 l A k t
toktoktoktokt	" t O k $ t O k $ t O k $ % t O k t
kometkameraten	k U $ " m e: t $ k A $ m @ $ % r A: $ t n=
mmmmmmnæ	" m m m $ n e:
jordbærn	" j U r $ b {: n`
hadeee	" h {*I d e:
stjæl	"" s t j e: l
milikilibolla	" m i: $ l I $ k I $ l I $ " b O $ l A
bilhammer	"" b i: l $ % h A $ m @ r
perci	" p 2: $ S I
errrerrre	" { $ r $ n`= r
gyk	" j y: k
spæll	"" s p {: l
ylvaylvaylvaylva	"" Y l $ v A*I $ l f A*I $ l A: Y l $ v A
spillspilllikelikeli	" s p I l $ s p I l $ l i: $ k @ $ l i: $ k @ $ % l i:
fortæll	f O $ " t` {: l
gulpebil	"" g u0 l $ p @ $ % b i: l
dåkk	"" d O k
apekattajoggert	"" A: $ p @ $ % k A $ t A $ % j O $ g @ t`
potan	p O $ " t A: n
neeeehei	" n e: e: $ % h {*I
brukikke	"" b r u: $ k I $ k @
bitibæti	"" b i: $ t I $ b {: $ t I
eplejoggert	"" E $ p l @ $ % j O $ g @ t`
blablå	b l A $ " b l o:
waaaa	"" v o: $ % o:
tuttitutututu	t u0 $ t I $ " t u0 t $ t Y $ " t y:
ædabæda	e: $ d A: $ b @ $ d A
fiskeskjær	"" f I $ s k @ $ % S {: r
racerbiln	" r e: $ s @ r $ % b i: l n
klissevåt	"" k l I $ s @ $ % v o: t
laalalalala	" l o: $ % l A l A: $ l A
ilakirka	"" i: $ l A $ % C I r $ k A
kosetutt	"" k u: $ s @ $ % t u0 t
værte	"" v {: $ t` @
aaaaaaaai	"" O O O A*I
hårbørstn	"" h o: r $ b 9 s` t` $ n`
ropperdak	"" r O $ p @ $ % d` A k
dotore	d U $ " t u: $ r @
krokodillbil	k r U $ k U $ "" d I $ l @ $ % b i: l
dlinge	% d e: $ l I N $ @
malebukse	"" m A: $ l @ $ % b U k $ s @
æger	e: $ g @ r
båtan	"" b o: $ t n=
dudududud	"" d u0 $ d u0 $ d u0 $ d u0 d
bopobopobpo	" b O $ p U $ b U $ " p O b $ p U
wæwæ	" v e: v e:
neieneieneie	"" n {*I $ @ n {*I $ @ n {*I $ @
dommerbiggel	"" d O $ m @ r $ % b I $ g @ l
magnetern	m A N $ " n e: $ t @ n`
hæhæhæhæh	"" h {: e: e: e:
månomånomåno	"" m o: $ n U $ m o: $ n U $ m o: $ n U
lakalaklekemi	"" l A: $ k A $ l A $ " k l e: $ k @ $ " m i:
isisisisis	" i: $ s I $ s I $ " s i: $ s I s
krøyp	" k r 9*Y p
maisn	" m A*I $ % s n
tæbedisj	" t e: $ b @ $ "" d I S
ååååååå	"" O O O O O O o:
beteost	"" b e: $ t @ $ % U s t
pappaløven	"" p A $ p A $ % l 2: $ v @ n
åååååå	"" O O O O O o:
wææææææ	" v e: @ @ @ @ e:
klæip	" k l E i: p
bjørnejakten	"" b j 2: $ n` @ $ % j A k $ t n=
tokola	"" t u: $ % k o: $ l A
mananananananan	" m E $ n @ $ " n E $ n @ $ n @ $ " n E $ n @ n
blånissedagen	"" b l o: $ % n I $ s @ $ % d A: $ g @ n
kjempemy	"" C E m $ p @ $ % m y:
lololo	l U $ "" l u: $ l U
nemmenemme	"" n E $ m @ $ % n E $ m @
tlikken	t l I $ k @ n
næmme	"" n E $ m @
iseiseise	" i: s {*I $ s {*I $ s @
børstn	" b 9 s` t` $ n`
bilibilabilibila	b I $ " l I $ b I $ l A $ b I $ l I $ " b i: $ l A
tannbørst	"" t A n $ % b 9 s` t
deeennnn	" d i: n`= $ n
oooooi	" u: }: O*Y
eeeeeeeeee	" e: e: e: e: e:
plejus	p l @ $ j u0 s
sinjuice	s I $ " n j }: s
tommerpugg	"" t O $ m @ r $ % p u0 g
mittilt	" m I $ t I l t
nænænæ	"" n {: $ % n {: $ n e:
pappatill	"" p A $ p A $ % t I l
ææi	" n {: {*I
lekespis	"" l e: $ k @ $ % s p i: s
storjentesykkel	"" s t u: r $ % j e: n $ t @ $ % s Y $ k @ l
hårbørste	"" h o: r $ % b 9 $ s` t` @
neieee	"" n {*I $ @ i:
dsssssmmmmm	% d e: $ @ s $ @ s $ @ s $ @ s $ @ s $ " m m m
nænænænæ	"" n {: $ % n E n e: $ n e:
lillelegon	"" l I $ l @ $ l @ $ " g u: n
utanpå	"" }: $ t A n $ % p o:
skrablepapegøye	s k r A $ " b l e: $ p A $ p @ $ "" g 9*Y $ @
støvat	"" s t 2: $ v A t
hvorfordi	" v U r $ f O $ " d` i:
litelitelite	" l i: $ t l= $ I t $ @ $ % l i: $ t @
åhoo	"" O $ " h }:
bippabippabippabippa	"" b I $ p A $ b I $ p A $ b I $ p A $ b I $ p A
bråkebil	"" b r o: $ k @ $ % b i: l
vertøyan	v @ $ "" t` 9*Y $ A n
påskepepperkake	"" p o: $ s k @ $ % p E $ p @ r $ % k A: $ k @
brbrbrbrbrbr	"" b r b r b r b r b r e: $ b e: $ " { r
loffaloff	"" l U $ f A l U f
gissn	"" j I $ s n
amnamnam	A m $ n A m $ " n A: m
nenenen	" n e: $ n E $ n n=
dåla	" d o: $ l A
biiil	b I $ " i: l
tykkelhjelm	"" t Y $ k @ l $ % j E l m
disdisdis	" d i: s $ d I $ s I $ " d i: s
harreharreharre	" h { $ r @ $ h A $ r @ $ " h A $ r @
ødlagt	" 2: d $ % l A k t
bebebebebeeee	b @ $ " b e: $ b @ $ " b E b i: e:
tykehuse	"" t Y $ k @ $ % h u: $ s @
påskeegge	"" p o: $ s k @ $ % E $ g @
æppejus	" n {: $ p @ $ j u0 s
isisis	% i: $ E s $ " i: $ s I s
æle	e: $ l @
plastern	p l A $ " s t {: n`
åhåhå	"" o: $ h O $ " h o:
ællemællemælle	E $ l @ $ m E $ l @ $ m E $ l @
bapapa	b A $ "" p A: $ p A
bedrebedrebedrebedre	b @ $ " d r e: $ b @ $ d r @ $ b @ $ d r @ $ b e: $ d r @
fvann	"" E f $ % v A n
tatatatatata	t A $ t A $ t A $ t A $ % t A: $ t A
tlipp	t l I p
dæss	" d E s
mammapappamammapappa	"" m A $ m A $ % p A $ p A $ % m A $ m A $ % p A $ p A
påskehare	"" p o: $ s k @ $ % h A: $ r @
mmmne	" m m $ n @
pæsstefar	"" p E $ s t @ $ % f A: r
dndndn	% d e: $ E n $ d e: $ " E n $ d e: $ " E n
medededemededede	"" m e: $ % d e: $ d @ $ d @ $ " m e: $ % d e: $ d @ $ d @
dååååå	" d o: $ % O O O o:
nmamamamama	"" E $ n @ m A m $ A $ m A $ " m A: $ m A
wæwæwæwæwæ	" v e: v e: v e: v e: v e:
håndklede	"" h O N $ % k l e: $ d @
nenenenene	" n e: $ n E $ n n= $ @ $ n @
bibibiola	b I $ b I $ b I $ " u: $ l A
flodhesta	"" f l u: d $ % h E $ s t A
manemanemane	m A $ " n e: $ m A $ n @ $ "" m A: $ n @
vvvvooooo	" v $ v U }: u:
sølsøl	"" s 9 l $ % s 2: l
uuuuui	u0 $ u0 }: i:
jenteskei	"" j E n $ t @ $ % S {*I
mhmhm	" m m m
kokehattn	k u: $ k @ $ " h A t $ n=
snølykt	"" s n 2: $ % l Y k t
oduler	U $ " d }: $ l @ r
oooow	" u: O v
dætt	" d E t
lammelammelam	"" l A $ m @ $ % l A $ m @ $ " l A: m
eeeeeeeeeeeee	" e: e: e: e: e: i: e:
nømann	" n 2: $ % m A n
blåbærstei	" b l o: $ b {: r $ % s t {*I
ææh	" n {: {:
båbåbølse	"" b o: $ b o: $ b 9 l $ s @
tånne	" t O $ n @
eplebok	"" E $ p l @ $ % b u: k
æplan	e: $ % p l A: n
kattehøyt	"" k A $ t @ $ % h 9*Y t
pinnsvinjoggert	"" p I n $ % s v i: n $ j O $ g @ t`
trollehus	"" t r O $ l @ $ % h }: s
tingapuslespill	"" t I N $ % A: $ p u0 $ s l @ $ % s p I l
legle	"" l E $ g l @
lalve	" l A l $ v @
ekkebokka	"" E $ k @ $ b O $ k A
hæhæhæ	"" h {: e: e:
fløteis	"" f l 2: $ t @ $ % i: s
tætæ	" t e: $ t e:
lilledottorn	"" l I $ l @ $ % d O $ % t u: n`
lilleboka	"" l I $ l @ $ % b u: $ k A
måremåre	"" m o: r $ @ m $ % o: $ r @
svisji	"" s v I $ S i:
bæææææbi	" b E @ @ @ e: $ b I
likelike	"" l i: $ k @ $ l i: $ k @
ringering	"" r I N $ @ $ % r I N
ræserbil	" r E $ s @ r $ % b i: l
ææ	" n {: e:
mikkelboka	"" m I $ k @ l $ % b u: $ k A
brøtuppe	"" b r 2: $ % t u0 $ p @
eplesyltetøy	"" E $ p l @ $ % s Y l $ t @ $ % t 9*Y
blåbærtaft	" b l o: $ b {: r $ % t A f t
hårsløyfe	"" h o: r $ % s` l 9*Y $ f @
nøkkeln	"" n 9 $ k @ l n
jappeja	"" j A $ p @ $ j A
æææææææ	" n {: @ @ @ @ @ e:
ylvakjeks	"" Y l $ v A $ % C E k s
bå	" b o:
simsamabim	"" s I m $ s A $ m A $ " b I m
politibila	p U $ l I $ " t i: $ % b i: $ l A
særli	"" s {: $ l` I
æppel	" n {: $ p @ l
idebelebe	I $ " d e: $ b @ $ " l e: $ b @
tangtangtang	"" t A N $ % t A N $ % t A N
bittesmåe	"" b I $ t @ $ % s m o: $ @
trikkepi	"" t r I $ k @ $ % p I
matbossn	"" m A: t $ % b O $ % s n
næmmenæmmenæm	"" n {: $ % m e: $ n @ $ " m e: $ n @ m
iiiiiis	% i: $ i: $ " i: i: s
åæ	"" O e:
mamamama	m A $ m A $ " m A: $ m A
fissi	f I $ " s i:
vertyøan	v @ $ t Y $ 2: $ A n
fuglebrød	"" f }: $ l @ $ % b r 2:
bæibi	" b {: $ i: $ " b i:
lillevogn	"" l I $ l @ $ % v O N n
plaskplask	"" p l A s k $ % p l A s k
tånner	" t O $ n @ r
shoppedame	"" S O $ p @ $ % d A: $ m @
bapaba	b A $ " p A: $ b A
bapappa	"" b A: $ % p A $ p A
bæsjebæsj	"" b E $ S @ $ b E S
vabin	v A $ " b i: n
kæss	" k @ s
politibilan	p U $ l I $ " t i: $ % b i: $ l A n
loffaloffaloffatorsk	"" l U $ f A l U $ f A l U f $ A $ % t O s` k
kommikommi	k U $ m I $ k U $ m I
nomenome	n U $ m @ $ n U $ m @
namename	n A $ m @ $ " n A: $ m @
løpesykkel	"" l 2: $ p @ $ % s Y $ k @ l
plitte	"" p l I $ t @
biiit	b I $ " i: t
endern	"" E n $ d @ n`
gagag	g A $ " g A: g
bakten	b A k $ t n=
kaspertann	" k A $ s p @ $ % t` A n
vvvvve	" v v $ v @
mæææære	"" m E @ @ $ " {: $ r @
dånner	"" d o: n $ n @ r
ædaæda	" n {: d e: $ d A
biiistikk	" b i: $ I $ I $ % s t I k
togstoln	"" t o: g $ % s t O l n
klære	" k l {: $ r @
ollebø	"" O $ l @ $ % b 2:
klistermerk	" k l I $ s t @ r $ % m { r k
dupedu	d u0 $ " p e: $ d u0
taxibiln	" t E k $ s I $ % b i: l n
iseis	"" i: s $ % {*I s
eliasbåtn	E $ " l i: $ A s $ b o: t $ n=
æl	e: l
ællæbællæbællææ	E $ l e: $ b E $ l e: $ b E $ l @ e:
blunost	"" b l u0 n $ % U s t
prtprt	"" p e: $ @ t` p t`
håhå	"" h o: $ % h o:
elelelela	E $ l @ $ l @ $ l @ $ l A
bettebo	" b E $ t @ $ % b u:
tokolade	t U $ k U $ % l A: $ d @
æbæbæbæb	e: $ b @ e: $ b @ b
ropestemmen	"" r u: $ p @ $ % s t E $ m @ n
neineineilalalala	" n {*I $ % n {*I $ % n {*I $ % l A l A: $ l A
begbegge	"" b e: g $ b E $ g @
gakagaka	" g A $ k A $ " g A: $ k A
hææææ	" h E @ @ e:
nissegrøtfest	"" n I $ s @ $ % g r 2: t $ % f E s t
pepperkakejonathan	"" p E $ p @ r $ k A: $ k @ $ % j u: $ n A $ " t A: n
frisørdama	f r I $ " s 2: r $ % d A: $ m A
pølsepølse	"" p 9 l $ s @ $ % p 9 l $ s @
tinkatinga	"" t I N $ k A $ " t I N $ A
bææææ	" b E @ @ e:
løm	"" l 9 m
balabalabala	b A $ l A $ " b A $ l A $ " b A: $ l A
angrybirds	"" A N $ g r Y b 2: d` s
øøøøøøøh	" 2: $ 2: $ 2: $ 2: $ 2: $ 2: $ 2:
rarararar	"" r A: $ r A $ r A $ r A r
løbber	"" l 9 $ b @ r
lebelebååå	l @ $ " b E $ l @ $ b O O o:
pappasild	"" p A $ p A $ % s I l
dutudutur	d Y $ " t y: $ d }: $ % t }: r
tøtt	"" t 9 t
hamhamham	"" h A m $ h A m $ h @ m
åjaaaa	"" O j o: $ % o:
klæ	"" k l e:
loffaloffa	"" l U $ f A l U $ f A
tlikk	t l I k
tæærn	" t e: {: n`
gutteis	"" g u0 $ t @ $ % i: s
åneeeei	% O n i: e: A*I
loffatoikloffaloffatoik	"" l U $ f A t $ O*Y $ k l U $ f A l U $ f A t $ O*Y k
doppi	" d O $ p I
brakkebrakkebrakkbrakkbrakk	"" b r A $ k @ $ % b r A $ k @ $ b r A k $ % b r A k $ % b r A k
buuuustikk	"" b }: }: $ s t I k
bussjåføren	" b u0 s $ S O $ % f 2: $ n`=
bablingblabling	"" b A $ b l I N $ % b l A $ b l I N
tolbær	"" t O l $ % b {: r
wowowowowo	" v E*u0 $ E*u0 $ E*u0 $ u: $ v U
eggebokka	"" E $ g @ $ % b O $ k A
oppaoppa	" O $ % p A $ O $ p A
dissebanen	"" d I $ s @ $ % b A: $ n n=
æglæglæ	E g l E g $ l @
gakga	"" g A k $ g A
bobobobowæææ	" b u: $ b O $ b O $ b O v e: @ e:
flyflyflyfly	" f l y: $ % f l y: $ f l y: $ % f l y:
ahare	A $ " h A: $ r @
skravlepapegøye	"" s k r A v $ l @ $ p A $ p @ $ "" g 9*Y $ @
pån	" p o: n
legofisk	" l e: $ g U $ % f I s k
sånnåsånnsånn	"" s O $ n O $ s O n $ s O n
jentekake	"" j E n $ t @ $ % k A: $ k @
æbæ	e: $ b @
bufsen	"" b u0 f $ s n=
æææææææsj	" n {: @ @ @ @ @ E S
bittebittebittbitt	"" b I $ t @ $ % b I $ t @ $ b I t $ % b I t
tynnlegger	"" t Y n $ % l E $ g @ r
tykebiln	"" t Y $ k @ $ b I l n
grøsj	"" g r 9 $ % S
dalalalala	"" d A: $ l A $ % l A: $ l A
larvepuslespillet	"" l A r $ v @ $ % p u0 $ s l @ $ % s p I $ l @
kakakakakakaka	k A $ k A $ k A $ k A $ k A $ % k A: $ k A
namnamanamnam	"" n A m $ % n A $ m A $ % n A m $ n A m
tatatat	t A $ " t A: $ t A t
dørris	"" d 2: r $ % r i: s
ælælææ	E l e: $ l @ e:
gølve	" g 9 $ l @
brannhatten	" b r A n $ % h A $ t n=
bombombombbom	"" b U m $ b U m $ b U m b $ % b U m
rissrissrissriss	" r I s $ % r I s $ % r I s $ % r I s
beibine	" b {*I $ "" b i: $ n @
ååååh	"" O O O o:
kliklaklappiklappeklappeklapp	"" k l I $ k l A $ % k l A $ p I $ k l A $ p @ $ % k l A $ p @ $ % k l A p
tullehus	"" t u0 $ l @ $ % h }: s
akkabokka	"" A $ k A $ " b O $ k A
sannsann	"" s A n $ % s A n
pliiiit	" p l i: $ i: t
labelavelydelydelyd	" l A: $ b @ $ l A $ v @ $ "" l y: $ d @ $ % l y: $ d @ $ % l y: d
taktaktatata	" t A k t $ % A k $ t A $ t A $ % t A:
tæss	"" t E s
isbitn	"" i: s $ % b i: t $ n=
tantantan	" t A n $ t A n $ " t A: n
dragejaktn	"" d r A: $ g @ $ % j A k t $ n=
pluppepluppe	" p l u0 $ p @ $ % p l u0 $ p @
wæwæwæwæ	" v e: v e: v e: v e:
kankanke	k A n $ " k A N $ k @
legobila	" l e: $ g U $ " b i: $ l A
gekeke	g @ $ "" k e: $ k @
blebleeeee	b l @ r I e:
wowowowo	" v E*u0 $ E*u0 $ u: $ v U
klissikliss	"" k l I $ s I $ "" k l I s
blålysdagen	"" b l o: $ l Y s $ % d A: $ g @ n
dedededede	d @ $ " d e: $ % d e: $ d @ $ d @
glille	"" g l I $ l @
dassedass	" d A s $ d A s
teineteineteine	"" t {*I $ n @ $ % t {*I $ n @ $ t A*I n
sovetutten	"" s o: $ v @ $ % t u0 $ t n=
tling	t @ $ l I N
brødsive	"" b r 2: $ % s i: $ v @
nøklen	"" n 9 k $ l @ n
heeeeeee	" h e: e: e:
nommenomenomenom	"" n U $ m @ $ n U $ m @ $ n U $ m @ $ " n u: m
gulegulegule	"" g }: $ l @ $ g u0 $ l e: $ % g }: $ l @
tripptrapptripp	" t r I p $ % t r A p $ % t r I p
hårstrikker	"" h o: r $ % s t r I $ k @ r
skilpaddeuki	"" S I l $ % p A $ d @ v $ k I
rabarbramuffin	r A $ " b A r $ b r A $ " m u0 $ f I n
ræserfort	" r E $ s @ r $ " f o: r
overraskelsa	"" o: $ v @ $ r A s k l= $ s A
storebrunost	"" s t u: $ r @ $ % b r }: n $ % U s t
hæst	" h E s t
sjokoa	S U $ k U $ A
loffatoikloffatoik	"" l U $ f A t $ O*Y $ k l U $ f A t $ O*Y k
skinkekjøtt	"" S I N $ k @ $ % C 9 t
pisepis	p I $ " s e: $ p I s
