hæ	h @
åh	"" o:
bæbu	" b {: $ % b }:
ønøn	" 9 $ % n 2: n
vææ	"" v E e:
ørnørn	"" 2: $ n` 2: n`
væææ	"" v E @ e:
næ	"" n e:
æh	" {:
åå	"" O o:
ææ	" n {: e:
bæbubæbu	" b {: $ b }: $ % b e: $ % b }:
ørnørnørn	"" 2: $ n` 9 $ n` 2: n`
bæbubæbubæ	" b {: $ b }: $ % b {: $ b }: $ b @
dædæ	"" d {: $ d e:
møø	" m 2: $ % 2:
øø	" 2: 2:
åj	"" O
ååå	"" O O o:
mjaumjau	"" m j E*u0 $ m j E*u0
øøøøø	" 2: $ 2: $ 2: $ 2: $ % 2:
høh	"" h 2:
pipemunn	"" p i: $ p @ $ % m u0 n
æææ	" n {: @ e:
gråtelyd	"" g r o: $ t @ $ % l y: d
øøøh	" 2: $ 2: $ 2:
ææiii	" n {: {*I $ I
bå	" b o:
åkken	"" O $ k @ n
makapaka	m A $ k A $ " p A $ k A
iaiaa	" i: $ @ O
mmhmhmhmmhmimidohoi	% E m $ E m $ " h m m $ " m m I $ m I $ d U $ " h O*Y
ønlnj	" 9 l` $ n j
mummul	m u0 $ "" m }: l
drømmehagen	"" d r 9 $ m @ $ % h A: $ g @ n
øøø	" 2: $ 2: $ % 2:
bæbubil	" b {: $ b }: $ % b i: l
vovvovvov	"" v O v $ % v O v $ % v O v
nønøn	" n 9 $ % n 2: n
øu	" 9 $ " }:
bæbubæbubæbubæbubæ	" b {: $ b }: $ % b E b 9 b {: $ b }: $ % b {: $ b }: $ b @
rådyrbukken	" r o: $ d y: r $ % b U $ k @ n
æu	@ $ " }:
øi	"" 9*Y
haheh	" h A: @
diddel	"" d I $ d l=
bææ	" b E e:
deterbæbubæbu	d @ $ " t { r $ b {: $ b }: $ % b e: $ % b }:
åååå	"" O O O o:
hvæ	" v @
næi	"" n E $ I
uæ	u0 $ @
nunøn	" n }: $ n 2: n
babam	" b A: $ b A m
øh	" 2:
bæbæ	" b e: $ b @
øhøhøh	" 2: 2: $ h 2:
derder	" d { $ r @ r
gakkgakkgakk	"" g A k $ % g A k $ % g A k
pappavovvov	"" p A $ p A $ % v O v $ % v O v
brrom	% b e: $ @ r $ % r U m
kjø	" C 2:
pappegøye	"" p A $ p @ $ "" g 9*Y $ @
nininina	" n I $ n I $ n I $ n A
næmmen	"" n {: $ % m E n
bæbubæ	" b {: $ b }: $ b @
dåtæ	" d o: $ t e:
jæ	" j e:
dæ	"" d e:
øøøø	" 2: $ 2: $ 2: $ % 2:
åhåhåhå	"" o: $ % h o: $ % h o: $ h o:
åja	"" o: $ j A
ånei	% O n {*I
ojaoja	O $ j A $ " O $ h A
bilderder	"" b I l $ d @ $ " d` e: r
æsjameg	E $ S A $ m {*I
abamabam	A $ b A $ m A $ " b A m
hønønøn	"" h 2: $ n 9 $ % n 2: n
øn	" 2: n
