bæsjehull	"" b E $ S @ $ % h u0 l
toår	"" t u: $ % o: r
brøløve	"" b r 2: $ % l 2: $ v @
heiabåt	" h {*I $ A $ % b o: t
uææ	u0 $ @ e:
opppå	" O $ % p o:
badekåpe	"" b A: $ d @ $ % k o: $ p @
blåt	" b l o: t
nøf	n 9 $ " E f
øø	" 2: 2:
frambåten	" f r A m $ % b o: $ t n=
støger	"" s t 2: $ g @ r
båtfly	"" b o: t $ % f l y:
dykkerbåt	"" d Y $ k @ r $ % b o: t
psjsj	"" p E $ @ $ S S
påhan	"" p o: $ h @ n
tobiassitt	t U $ " b i: $ A $ s I t
hongkongen	h O N $ " k O N $ @ n
gulerøtter	"" g }: $ l @ $ % r 9 $ t @ r
snekreting	"" s n E $ k r @ $ t I N
noiyi	n U $ " A: I
dunkebåt	"" d U N $ k @ $ % b o: t
dyremann	"" d y: $ r @ $ % m A n
klokkea	"" k l O $ k @ $ A
næ	"" n e:
innesk	I $ " n E s k
puogbue	"" p }: $ O $ % b }: $ @
vææ	"" v E e:
lillesimen	"" l I $ l @ $ "" s i: $ m @ n
gør	"" g 2: r
pipea	" p A*I $ % p A
knappegenser	"" k n A $ p @ $ % g E n $ s @ r
tryggebilen	"" t r Y $ g @ $ % b i: $ l n=
belax	b @ $ " l A k s
åh	"" o:
antonleke	" A n $ t U n $ % l e: $ k @
pøh	"" p 2:
tauemannen	"" t E*u0 $ @ $ % m A $ n n=
fordetat	"" f O $ d` @ $ % t A: t
julenissemann	"" j }: $ l @ $ % n I $ s @ $ % m A n
trykkebil	"" t r Y $ k @ $ % b i: l
åpnea	% o: p $ n I
fordiat	"" f O $ d` I $ " A: t
malingkost	"" m A: $ l I N $ % k O s t
hnmm	% h o: $ E n $ E m $ " E m
skriveborden	"" s k r i: $ v @ $ b u: s` $ n=
kssj	% k o: $ % S
ballstokk	"" b A l $ % s t O k
pæis	" p {*I s
tekannea	" t e: $ % k A $ " n e: $ A
sirkusdirektøren	" s I r $ k u0 s $ d I $ r @ k $ % t 2: $ n`=
snehuset	"" s n e: $ % h }: $ s @
tryggebil	"" t r Y $ g @ $ % b i: l
barnetanten	"" b A: $ n` @ $ % t A n $ t n=
leketrommer	"" l e: $ k @ $ % t r U $ m @ r
nesepapir	"" n e: $ s @ $ p A $ % p i: r
øøø	" 2: $ 2: $ % 2:
sjokoladestangen	S U $ k U $ "" l A: $ d @ $ % s t A N $ @ n
uæee	u0 $ @ i:
ææ	" n {: e:
stupebratt	"" s t }: $ p @ $ % b r A t
yyyda	" j $ y: $ d A
faltern	"" f A l $ t @ n`
kardemommeteater	k A $ d` @ $ "" m U $ m @ $ t @ $ % A: $ t @ r
tørketrommeler	"" t 9 r $ k @ $ % t r U $ m @ $ l @ r
pilogbuen	p I $ " l o: g $ % b }: $ @ n
hoppesild	"" h O $ p @ $ % s I l
morsitt	" m u: r $ % s I t
griseboken	"" g r i: $ s @ $ % b u: $ k @ n
sofiesanger	s U $ " f i: $ @ $ % s A N $ @ r
khanin	k A $ " n i: n
trilleleren	"" t r I $ l @ $ l @ $ n`=
oaoa	" E*u0 o: $ A
khuu	" k u0 $ " }:
næee	"" n E i:
karaffelmann	k A $ " r A $ f @ l $ % m A n
trrrr	"" t r r
klistretingene	"" k l I $ s t r @ $ % t I N $ @ $ n @
måikke	m O $ " I $ k @
heiabåten	" h {*I $ A $ % b o: $ t n=
liksomutesko	" l I k $ s U $ m U $ " t E $ s k U
melkesjø	"" m E l $ k @ $ % S 2:
julegråten	"" j }: $ l @ $ % g r o: $ t n=
dnhnhæ	% d e: $ E n $ " h $ h e:
bråkebøte	"" b r o: $ k @ $ % b 2: $ t @
uuuui	% }: $ }: $ " }: i:
storetå-en	"" s t u: $ r @ $ t O $ @ n
nissetøffeler	"" n I $ s @ $ % t 9 $ f @ $ l @ r
nedern	"" n e: $ d @ n`
dzzz	" d $ s
oppiden	" O $ p I $ d n=
slalomskinnene	"" S l A $ l O m $ % S I $ n n= $ @
atteskap	A $ t @ $ " s k A: p
yyyjern	" j $ j j {: n`
pølsebutikken	"" p 9 l $ s @ $ b u0 $ % t I $ k @ n
brmm	% b e: $ @ r $ @ m $ " E m
dnæi	% d e: $ E n $ " {*I
julestrømper	"" j }: $ l @ $ % s t r 9 m $ p @ r
blåen	"" b l o: $ @ n
katteklovnen	"" k A $ t @ $ % k l O v $ n n=
hyttea	"" h Y $ t A
posekamelen	"" p u: $ s @ $ k A $ " m e: $ l n=
skjøyter	"" S 9*Y $ t @ r
fyamegog	f Y $ A $ m @ $ "" g u: g
brøløven	"" b r 2: $ % l 2: $ v @ n
æsjer	E $ S @ r
nissestrømper	"" n I $ s @ $ % s t r 9 m $ p @ r
klistreting	"" k l I $ s t r @ $ % t I N
tøffeler	" t 9 $ f @ $ l @ r
tzzz	" t $ s
bebiapekatten	" b e: $ b I $ % A: $ p @ $ % k A $ t n=
tøffelnisse	" t 9 $ f @ l $ % n I $ s @
dbbb	" d $ b
kardemommebysangen	k A $ d` @ $ "" m U $ m @ $ b y: $ % s A N $ @ n
kruseskjell	"" k r }: $ s @ $ % S E l
morsin	"" m O $ s` I n
kjøkkenting	" C 9 $ k @ n $ % t I N
vinterhøner	"" v I n $ t @ r $ % h 2: $ n @ r
måneskjorte	"" m o: $ n @ $ % S U $ t` @
månebukse	"" m o: $ n @ $ % b U k $ s @
massern	m A $ " s {: n`
slipetang	"" S l i: $ p @ $ % t A N
kleutkamelen	k l @ $ u0 t $ % k A: $ m @ l n
pkj	% p e: $ C
