det	d e t
eh	" " e: $ % h o:
på	" p o:
som	" " s O m
där	d E: r
den	d e n
liksom	" " l i: k $ s O m
alltså	a l t $ " s o:
okej	" " u: $ s' e j
av	" " A: v
någon	" " n o: $ g O n
bra	" " b r a
mer	" m e: r
få	" f o:
cont	k O n t
mhm	m m
några	" " n o: $ r a
sådan	" " s o: $ d a n
många	m O N $ a
än	" e n
efter	" " e f $ t e r
hära	" " h E: $ r a
ehm	" e: m
såhära	s o: $ " h E: $ r a
mest	" m e: s t
bort	" " b O t`
sett	" s e t
varje	" " v a r $ j e
ibland	" " i: $ b l a n d
vaddå	v a $ " d o:
sån	" s o: n
flera	" " f l e: $ r a
ifrån	I $ " " f r o: n
vart	v a t`
maybe	" m a j $ b e
bakom	" " b A: $ k O m
utav	}: $ t A: v
annorlunda	" " a $ n U $ % l` u0 n $ d a
enda	" " e n $ d a
mindre	" " m I n $ d r e
stort	" " s t u: t`
jäkla	" " j E: $ k l a
förstås	f 9 $ " s` t` o: s
shit	" s` i: t
hit	" h I t
right	r a j t
utanför	" " }: $ t a n $ % f 2: r
exjobbet	" " e k s $ % j O $ b e t
vic	v I k
igenom	I $ " j e: $ n O m
emot	" e $ m u: t
nehe	n e $ " h e
yawning	" j O $ n I N
förbi	f 9 r $ " b I
omkring	" " O m $ k r I N
exjobb	" " e k s $ % j O b
otroligt	" " u: $ % t r u: $ l I k t
minsta	" " m I n $ s t a
dära	" d E: $ r a
sånhära	" s O n $ h e $ r a
njae	" n j A:
najs	" " n a j s
pressad	" " p r e $ s a d
datorinteraktion	" " d A: $ t U r $ I n $ t e $ r a k $ " x\ u: n
lagom	" " l A: g $ O m
extra	" " e k $ s t r a
bytt	" b Y t
akvarium	a $ " " k v A: $ r I $ u0 m
it	" i: t
sådära	s o: $ " d E: $ r a
tioman	" " t i: $ U $ % m a n
r-ettan	" " e r $ % e $ t a n
dialogsystem	d i: $ a $ " " l o: g $ s Y $ % s t e: m
jämt	" j e m t
caset	" " k A: $ s e t
undan	" " u0 n $ d a n
keff	" k e f
tills	t I l s
medieteknik	" " m e: $ d I $ e $ t e $ % k n i: k
headset	" h e d $ s e t
question	" " k v e $ " x\ u: n
you	" " j u:
acronym	" a $ k r U $ " n y: m
frameraten	" " f r a $ m e $ " r A: $ t e n
facebook	f a $ s e $ " b U k
emellan	" e $ m e $ l a n
reach	" " r e: $ a k
prolonged	p r U $ l O N $ " g e: d
tre-d	" " t r e: $ % e d
härom	" " h E: $ % r O m
spontal	s p O n $ " t A: l
hemmafest	" " h e $ m a $ % f e s t
thia	" " t i: $ a
allright	a l $ " r a j t
faan	" f A: n
datat	" " d A: $ t a t
utifrån	" " }: t $ I $ % f r o: n
chockad	" " x\ O $ k a d
masterprogram	" " m a s $ t e r $ p r U $ % g r a m
solvagnen	" " s u: l $ % v a N $ n e n
köttklistret	" " s' 9 t $ % k l I $ s t r e t
apropå	a $ " " p r O $ " p o:
jacuzzi	" " j A: $ k u0 $ s I
pont	" p O n t
kopplad	" " k O $ p l a d
mesta	" " m e $ s t a
multiplayer	m u0 l $ " t I $ p l a $ j e r
mördarkaniner	" " m 2: $ d` a r $ k a $ % n i: $ n e r
köttlim	" " s' 9 t $ % l I m
cern	" " s E: n`
reflexivitet	r e $ f l e k $ s i: $ v I $ " t e: t
onödigt	" " u: $ n 2: $ d I k t
tennistränaren	" " t e $ n I s $ % t r E: $ n a $ r e n
sjuttiosjua	x\ u0 $ t I $ U $ " x\ }: $ a
odst	U d s t
grejjer	" g r e j $ j e r
fridhemsplan	" " f r i: d $ h e m s $ % p l A: n
brunch	b r u0 N k
andraspråksinlärning	" " a n $ d r a $ % s p r o: k s $ I n $ % l E: $ n` I N
csnbidrag	s e: $ e s $ " e n $ b i: $ % d r A: g
li	" l i:
talar	" " t A: $ l a r
sämre	" s e m $ r e
flyer	" " f l y: $ e r
skitschysst	" " x\ i: t $ x\ Y s t
smsade	" s m $ s a $ d e
fyllda	" " f Y l $ d a
vegan	" " v e: $ g a n
dehuminize	d e $ h }: $ m I $ n i: s
surdegsbröd	" " s }: $ % d` e: g s $ % b r 2: d
tjugoåttonde	s' }: $ g U $ " " O $ t O n $ d e
durian	" " d }: $ r I $ a n
björkbord	" " b j 9 r k $ % b u: d`
unknown	" " u0 N $ k n a*U n
manana	m a $ " n A: $ n a
vakuumservice	" " v A: $ k u0 m $ % s 9 r $ v I s
groggy	" " g r O $ g Y
översatt	" " 2: $ v e $ % s` a t
sånhär	" s o: n $ % h E: r
uttråkad	" " }: t $ % t r o: $ k a d
jesse	" " j e $ s e
english	e N $ " l I s`
dissar	d I $ s a r
rehabiliteringshemmet	r e $ h a $ b I $ l I $ " " t e: $ r I N s $ % h e $ m e t
draknästet	" " d r A: k $ % n e $ s t e t
litegranna	l i: $ t e $ " g r a $ n a
jättelängesen	" " j e $ t e $ % l e N $ e $ % s e n
brutes	" " b r }: $ t e s
skitsur	" " x\ i: t $ % s }: r
uh	}: $ h o:
file	" " f i: $ l e
tionde	" " t i: $ O n $ d e
cues	" k y: s
idiotgrejer	I $ d I $ " " u: t $ % g r e $ j e r
thats	" " t A: t s
södertips	" " s 2: $ d e $ % t` I p s
slot-tider	" s l O t $ % t i: $ d e r
helgplaner	" " h e l j $ % p l A: $ n e r
hieronymus	h I $ e $ r U $ " n y: $ m u0 s
roti	r U $ " t i:
turtagning	" " t }: $ % t` A: $ g n I N
rödbetssallad	" " r 2: d $ b e: t s $ % s a $ l a d
skitdålig	" " x\ i: t $ % d o: $ l I g
mocapen	" " m u: $ % k E: $ p e n
tvingad	" " t v I N $ a d
attached	a $ t a $ " s` e d
skype	" s k a j p
vecchia	" v e $ k I $ a
vetefan	" " v e: $ t e $ % f A: n
badtofflor	" " b A: d $ % t O $ f l U r
medwurst	m e $ d v u0 s` t`
sigh	" s i: g
doldakameramoment	" d o: l $ d a $ " k A: $ m e $ r a $ m U $ % m e n t
seminarierna	s e $ m I $ " " n A: $ r I $ e $ n` a
frame	" f r a $ m e
rekomendera	r e $ k O $ m e n $ " d e: $ r a
sofo	" s o: $ f U
cause	" k o: s
kloppeti	" k l O $ p e $ t a
sveriges	" " s v e r $ j e s
konverserande	k O n $ v e $ " s` e: $ r a n $ d e
konstbranschen	" " k O n s t $ % b r a n` $ s` e n
köksverktyg	" " s' 9 k s $ v e r k $ % t y: g
cket	s e: $ k e t
tygkassarna	" " t y: g $ % k a $ s a $ n` a
chunky	" s' U N $ k Y
youtube	j U $ % t u: $ b e
days	" d e j s
martin	" " m a $ t` I n
neuronnät	n e $ " v r o: n $ % n E: t
knights	" k n a j t s
minst	" m I n s t
disgust	d I s $ g u0 s t
tjugusjunde	s' }: $ g U $ " " x\ u0 n $ d e
jätteintresserade	" " j e $ t e $ I n $ t r e $ % s e: $ r a $ d e
videokamerorna	" " v i: $ d e $ U $ % k A: $ m e $ r U $ n` a
högre	" " h 2: $ g r e
turhållande	" " t }: r $ % h O $ l a n d $ d e
nätstrumpbyxor	" " n E: t $ % s t r u0 m p $ % b Y k $ s U r
vetekatten	" " v e: $ t e $ % k a $ t e n
afterwork	" " a f $ t e r $ v 2: r k
samlargrejer	" " s a m $ l a r $ % g r e $ j e r
avalanche	" " A: $ v a $ % l a n` s`
högt	" " h 9 k t
obvious	O p $ " v u: s
charklim	" " x\ a r k $ % l I m
asbra	" A: s $ b r a
konstprojekt	" " k O n s t $ p r U $ % x\ e k t
elites	e $ l I $ " t e: s
seniora	s e $ n I $ " o: $ r a
ritrovo	r I $ t r O $ v U
say	" s e j
robinson	r O $ b I n $ s O n
flighter	" f l a j $ t e r
limmat	" " l I $ m a t
think	" " t I N k
fejk	" f e j k
jättegärna	" " j e $ t e $ % j E: $ n` a
walks	" v o: k s
hate	" h A: $ t e
frulla	f r u0 $ l a
cameron	k a $ m e $ " r o: n
dice	d I s
heights	" h e $ j t s
robinsonlåda	r O $ b I n $ s O n $ % l o: $ d a
hammarbysjöstad	" " h a $ m a r $ b y: $ % x\ 9 $ s t a d
scissorshands	" " s k I $ s U s` $ h a n d s
sofonight	s U $ " " f o: N a j t
one	" U $ a n
skedvi	" " x\ e: d $ % v i:
karro	k a $ r O
betongblomman	b e $ " " t O N $ % b l U $ m a n
hammarbybacken	" " h a $ m a r $ b y: $ % b a $ k e n
tussauds	" " t u0 $ s a*U d s
meaning	m e $ " A: $ n I N
left	" l e f t
skavlöten	" " s k A: v $ l 2: $ t e n
norwegian	n U r $ " v e: $ g I $ a n
fritzl	" f r I t $ s l
köpmannsföreningen	" " s' 2: p $ m a n s $ f 9 r $ % e: $ n I N $ e n
mundus	m u0 n $ " d }: s
alvån	" " a l v $ % o: n
ponts	" p O n t s
grail	" g r e j l
creed	" k r i: d
silicon	s I $ l I $ k O n
holy	" h O $ l Y
kungsholmsstrand	" " k u0 N s $ h O l m s $ % s t r a n d
ratsit	" " r a t $ s I t
göransgatan	" " j 2: $ r a n s $ % g A: $ t a n
tcentralen	t e: $ s e n $ % t r A: $ l e n
su	" s }:
skärholmens	" " x\ E: r $ % h O l $ m e n s
pandoras	p a n $ " " d o: $ r a s
mtr	e m $ t e: $ " e r
norwegain	" n O $ r $ g e j n
nerina	n e $ " r i: $ n a
ritovo	" r I $ t O $ v U
spiros	" " s p i: $ r U s
dead	" d e d
krauta	" k r a*U $ t a
thorildsplan	" " t u: $ r I l d s $ % p l A: n
work	" v 9 r k
sverge	" s v e r $ g e
cdio	s e: $ d I $ U
guvé	g }: $ " v e:
e-i	" " e: $ i:
maus	" m o: s
lindhagsplan	" " l I n d $ h A: g s $ % p l A: n
thorhildsplan	" t u: r $ h I l d s $ % p l A: n
mcdonalds	m a k $ " d O $ n a l d s
tmh	t m
rtm	r t m
victjugan	v I k $ " " s' }: $ g a n
fetmats	" " f e t $ m a t s
creosote	" k r e $ U $ " s o: $ t e
sls	" s l s
sofiaskolan	s U $ " " f i: $ a $ % s k u: $ l a n
pons	" p O n s
bicom	b I $ " k O m
järvheden	" " j e r v $ % h e: $ d e n
matlab-grejen	" " m A: t $ l A: $ " " b e: $ % g r e $ j e n
victjugofyran	v I k $ s' }: $ g U $ " " f y: $ r a n
ibson	" I b $ s O n
battlefield	b a $ t e l $ f i: l d
fourier	f U $ r I $ e r
koh	" k O
eniro	e $ " n i: $ r U
cod	" k o: d
academic	a $ k a $ " " d e: $ m I k
ououou	U $ " a*U U
cscskolan	s e $ s e $ e s $ % s k u: $ l a n
orose	" " u: $ r u: s $ e
ekebysjön	" " e: $ k e $ b y: $ % x\ 9 n
lei	" l e j
ilvall	" " I l $ v a l
pirre	" p I $ r e
kunskapsavdelningen	" " k u0 n $ s k A: p s $ A: v $ % d e: l $ n I N $ e n
saab	" " s A: b
soap	s U $ " " A: p
assassins	a $ " s a $ " s i: n s
vickos	" " v I $ k O s
splinter	" " s p l I n $ t e r
lammsalsiccia	" " l a m $ % s A: l $ s I k $ s I $ a
ammis	a $ m I s
skånefredrik	" " s k o: $ n e $ " f r e: $ d r I k
datatronic	" " d A: $ t a $ t r O $ n I k
lennox	" l e $ n O k s
monenoke	m O $ n e $ " n O $ k e
oneohone	" " u: $ % n e: $ O $ h O $ n e
carpark	" k A: r $ p a r k
blanciga	" " b l a N $ k I $ g a
mauson	m a*U $ s U n
records	r e $ " k o: d` s`
connely	k O $ " n e $ l Y
katameya	k a $ t a $ m e $ j a
källhagen	" " s' e l $ % h A: $ g e n
marktema	" " m a r k $ % t e: $ m a
brother	" " b r u: $ t e r
ieronimus	I $ " E: $ r U $ n I $ m u0 s
andolf	a n $ d O l f
renstiernas	r e n $ % x\ E: $ n` a s
phangan	f a N $ a n
vikabröd	" " v i: $ k a $ % b r 2: d
