det	d e t
som	" " s O m
på	" p o:
den	d e n
där	d E: r
eh	" " e: $ % h o:
av	" " A: v
alltså	a l t $ " s o:
liksom	" " l i: k $ s O m
bra	" " b r a
mer	" m e: r
få	" f o:
okej	" " u: $ s' e j
än	" e n
sån	" s o: n
detta	d e $ t a
många	m O N $ a
några	" " n o: $ r a
utav	}: $ t A: v
bort	" " b O t`
efter	" " e f $ t e r
kroner	" " k r u: $ n e r
mhm	m m
någon	" " n o: $ g O n
ifrån	I $ " " f r o: n
sett	" s e t
varje	" " v a r $ j e
ibland	" " i: $ b l a n d
mindre	" " m I n $ d r e
mest	" m e: s t
krone	" " k r u: $ n e
stort	" " s t u: t`
tjuge	" " s' }: $ g e
ru	r U
flera	" " f l e: $ r a
enda	" " e n $ d a
igenom	I $ " j e: $ n O m
talar	" " t A: $ l a r
hit	" h I t
emot	" e $ m u: t
vart	v a t`
numro	n u0 m $ " r u:
omkring	" " O m $ k r I N
utanför	" " }: $ t a n $ % f 2: r
åttinie	" " O $ t I $ n I
förstås	f 9 $ " s` t` o: s
näej	" " n E: $ e j
bakom	" " b A: $ k O m
hä	" " h E:
sämre	" s e m $ r e
naturprodukt	n a $ " " t }: r $ p r U $ % d u0 k t
hära	" " h E: $ r a
enligt	" " e: n $ l I k t
uh	}: $ h o:
you	" " j u:
tills	t I l s
emellan	" e $ m e $ l a n
äm	e m
femtionie	" " f e m $ t I $ U $ " " n i: $ e
sådan	" " s o: $ d a n
näeh	" " n E: $ e
utifrån	" " }: t $ I $ % f r o: n
tatt	t a t
mesta	" " m e $ s t a
fråger	" " f r o: $ g e r
högre	" " h 2: $ g r e
extra	" " e k $ s t r a
annorlunda	" " a $ n U $ % l` u0 n $ d a
vettu	" " v e $ % t }:
högt	" " h 9 k t
niehundra	" n i: $ " h u0 n $ d r a
fyrtionie	" " f 9 $ t` I $ O $ n I
tebaka	t e $ " b A: $ k a
otroligt	" " u: $ % t r u: $ l I k t
sempel	" s e m $ p e l
minst	" m I n s t
övrigt	" " 2: v $ r I k t
människer	" m e $ n I $ s k e r
tjugefem	" " s' }: $ g e $ " f e m
ma	m a
hah	" h A:
sku	" s k u0
esempel	e $ " s e m $ p e l
värre	" " v e $ r e
undan	" " u0 n $ d a n
faan	" f A: n
osså	" " O $ % s o:
2.0	" t v o: _ n
relativt	" r e $ l a $ t i: f t
främst	" f r E: m s t
dä	" d E:
jämt	" j e m t
it	" i: t
angående	" " a n $ % g o: $ e n $ d e
förbi	f 9 r $ " b I
tjugofyra	s' }: $ g U $ " " f y: $ r a
martin	" " m a $ t` I n
tionde	" " t i: $ O n $ d e
näh	" " n E:
vatt	" v a t
elle	" " e $ l e
änna	e $ n a
nänä	n e $ " n E:
närmast	" " n e r $ m a s t
onödigt	" " u: $ n 2: $ d I k t
its	i: $ t e: $ " e s
neej	" n j e j
naä	" n e E
seminarium	s e $ m I $ " " n A: $ r I $ u0 m
allså	" " a l $ s O
ovanpå	" " o: $ v a n $ % p o:
lagom	" " l A: g $ O m
fi	" f I
vecker	" " v e $ k e r
aldri	a l $ " d r i:
högst	" " h 9 k s t
hundrasjuttiofem	" " h u0 n $ d r a $ " " x\ u0 $ t I $ U $ " f e m
sä	" s E:
faen	f a $ e n
nat	" n A: t
ba	b a
dära	" d E: $ r a
ente	" " e: n $ t e
volvo	" " v O l $ v U
that	" " t A: t
någorlunda	" " n o: $ g O r $ % l` u0 n $ d a
övertygad	$ 2: $ v e $ % t` y: $ g a d
ähm	E: m
bytt	" b Y t
varannan	v a $ " " r a $ n a n
unkel	" " u0 N $ k e l
genast	" " j e: $ n a s t
vesst	" v e s t
njaa	" n j A:
sider	" " s i: $ d e r
jao	" j a*U
frågerna	" " f r o: $ g e $ n` a
thank	" t a N k
fyratusen	" " f y: $ r a $ % t }: $ s e n
öpp	% 9 p
påverkad	" " p o: $ % v e r $ k a d
disclaimer	" d I s k l e j $ m e r
minsta	" " m I n $ s t a
li	" l i:
intill	I n $ " t I l
åå	o:
informationsservice	I n $ f O r $ m a $ " " x\ u: n s $ % s 9 r $ v I s
mt	m t
nae	" n a j
1.5	" e t _ u0
tebaks	t e $ " b A: k s
samt	" s a m t
nature	n a $ " " t }: $ r e
oändligt	U $ " " e n d $ l I k t
säj	" s e j
negativt	" n e $ g a $ t i: f t
jäkla	" " j E: $ k l a
ra	" r a
uum	" }: $ m
grovt	" " g r u: v $ % t e:
hetter	" " h e $ t e r
lä	" l E:
känsler	" " s' e n $ s l e r
well	" v e l
gödsel	" " j 9 t $ s e l
vetdu	" " v e: t $ % d u0
um	" " }: $ % e m
energikäller	e $ n e r $ " " x\ i: $ % s' e $ l e r
isåfall	" " i: $ % s o: $ % f a l
apropå	a $ " " p r O $ " p o:
hundratjugofem	" " h u0 n $ d r a $ s' }: $ g U $ " f e m
sextinie	" " s e k $ s t I $ n I
nittonhundra	" " n I $ t O n $ h u0 n $ d r a
naturmedecin	n a $ " " t }: r $ m e $ d e $ " s i: n
vja	v e: $ j a
sveriges	" " s v e r $ j e s
tesempel	t e $ " s e m $ p e l
itte	" I t
orangea	U $ r a n` $ s` e $ " A:
verkstäder	" " v e r k $ % s t E: $ d e r
there	" t E: r
gabbemattan	" g a $ b e $ % m a $ t a n
mv	" e m $ v e:
trettonhundra	" " t r e $ t O n $ h u0 n $ d r a
noläs	n U $ " l E: s
väldit	" " v E: l $ d I t
3.0	" t r e: $ r e n
lillköping	" " l I l $ % s' 2: $ p I N
blommer	b l U $ m e r
ovanför	" " o: $ v a n $ % f 2: r
we	" v e
varsegod	" " v A: $ s` e $ % g u: d
kunne	" " k u0 $ n e
gifter	" " j I f $ t e r
knowledge	" k n O v $ l e: d s`
nångång	" n o: N $ % g O N
stimuli	s t I $ m }: $ " " l i:
seminariet	s e $ m I $ % n A: $ r I $ e t
varsego	" " v A: $ s` e $ g U
her	h e r
procedurell	p r U $ s e $ " d }: $ r e l
storköping	" " s t u: r $ % s' 2: $ p I N
hundranittio	" " h u0 n $ d r a $ " n I $ t I $ U
fredags	" " f r e: $ d A: g s
scandia	s k a n $ d I $ a
någe	" " n o: $ g e
sagts	" s a k t s
ehm	" e: m
frriä	f r i: $ E
2.5	" t v o: _ u0
trygghansa	" " t r Y g $ h a n $ s a
have	" h A: $ v e
någet	" " n o: $ g e t
spelbutiken	" " s p e: l $ b }: $ % t i: $ k e n
predikatlogik	p r e $ d I $ " " k A: t $ l U $ % g i: k
barna	" " b A: $ n` a
tjugofemte	s' }: $ g U $ " " f e m $ t e
köre	" " k 2: $ r e
vaddå	v a $ " d o:
härigeme	" h E: r $ I $ j e: $ m e
värst	" " v e s` t`
unicorn	u0 $ n I $ " k o: n`
haa	" h A:
förvånad	f 9 r $ " v o: $ n a d
kallad	" " k a $ l a d
tjugoandra	s' }: $ g U $ " " a n $ d r a
tjugonionde	s' }: $ g U $ " " n i: $ O n $ d e
lillstad	" " l I l $ s t A: d
thats	" " t A: t s
lå	" l o:
jahaha	j a $ h a $ " h A:
vijaha	v I $ " j A: $ h a
väsker	" " v e $ s k e r
öhm	9 m
skrive	" " s k r i: $ v e
utåt	" " }: t $ o: t
allafall	a $ l a $ " f a l
this	" " t I s
komme	k O $ m e
kvinner	" " k v I $ n e r
how	" h O v
vå	" v o:
behö	b e $ " h 2:
jör	" " j 2: r
mener	" m e: $ n e r
innanför	" " I $ n a n $ % f 2: r
härom	" " h E: $ % r O m
procedurella	p r U $ s e $ " d }: $ r e $ l a
interrent	I n $ t e r $ " r e: n t
juinte	" j u: n t
hundratjuge	" " h u0 n $ d r a $ " " s' }: $ g e
litegranna	l i: $ t e $ " g r a $ n a
myck	" m Y k
frja	f r I $ a
trettionie	" " t r e $ t I $ U $ " " n i: $ e
very	v e $ r Y
fullmäktige	" " f u0 l $ m e k $ t I $ g e
rä	" r E:
akademiska	a $ k a $ " d e: $ m I $ s k a
4.0	" " f y: $ r a $ r e n
jajamen	" " j a $ j a $ % m e n
säge	" " s E: $ g e
knallhagevägen	" " k n a l $ h A: $ g e $ % v E: $ g e n
lejonkungen	" " l e $ j O n $ % k u0 N $ e n
what	v e $ h O $ " A: t
mongo	m O N $ " g u:
ae	e
ingeting	" " I n $ % j e: $ t I N
ikan	I $ " k A: n
discourse	" d I $ s k U $ " s` e:
säje	" s e $ j e
uppifrån	" " u0 $ p I $ f r o: n
njae	" n j A:
cobol	k O $ " b o: l
inuti	" " I $ n u0 $ % t i:
barntröjer	" " b A: n` $ t` r 9 $ j e r
engagerad	a N $ g a $ " x\ e: $ r a d
gabbematta	" g a $ b e $ % m a $ t a
lilleby	" " l I $ l e $ % b y:
one	" U $ a n
two	" t u:
gabbe	" g a $ b e
natu	n a $ t u0
kollektivet	k O $ l e k $ t i: $ v e t
stilspegeln	" " s t i: l $ % s p e: $ g e l n
words	" v 2: d` s`
väskerna	" " v e $ s k e $ n` a
tjugofjärde	s' }: $ g U $ " " f j E: $ d` e
djävla	" " j E: v $ l a
ruller	" " r u0 $ l e r
hundrasjuttio	" " h u0 n $ d r a $ " " x\ u0 $ t I $ U
jorå	" j u: $ r o:
barndressarna	" " b A: n` $ % d r e $ s a $ n` a
äe	" E: $ e
fatt	" f a t
crille	k r I $ l e
seminarier	s e $ m I $ " " n A: $ r I $ e r
språkinlärare	" " s p r o: k $ I n $ % l E: $ r a $ r e
tjunie	" s' }: $ n I
förvirrad	f 9 r $ " v I $ r a d
deklarativt	d e $ k l a $ r a $ t i: f t
sjuttinie	x\ u0 $ t I $ " " n i: $ e
five	" " f i: $ v e
påtagligt	" " p o: $ % t A: $ g l I k t
sjs	s`
naej	n a $ " e j
avvecklingsplan	" " A: v $ v e $ k l I N s $ % p l A: n
tjugoförsta	s' }: $ g U $ " " f 9 $ s` t` a
fatbuveratt	" " f A: t $ b }: $ v e $ r a t
tillesempel	" " t I l $ e: $ s e m $ p e l
agusti	a $ " g u0 $ s t I
därnt	d E: n` t`
mmm	e m $ e m $ " e m
förmiddag	" " f 2: r $ m I $ % d A: g
hundratie	" " h u0 n $ d r a $ " " t i: $ e
aaa	" " o: $ a
ga	" g a
sätte	" " s e $ t e
flicker	" " f l I $ k e r
kommet	" " k O $ m e t
esic	" e: $ s I t s'
ee	" e:
skapad	" " s k A: $ p a d
styrtexten	" " s t y: $ % t` e k $ s t e n
toblerone	" t u: $ b l e $ " r o: $ n e
moster	" m U $ s t e r
die	" d i:
jä	" j E:
tale	" " t A: $ l e
insett	" " I n $ % s e t
prate	" p r A: $ t e
arbets	" " a r $ b e: t s
åttatusen	" " O $ t a $ % t }: $ s e n
lome	" l o: $ m e
domnarvet	" " d O m $ % n a r $ v e t
barntröjorna	" " b A: n` $ % t` r 9 $ j U $ n` a
robinson	r O $ b I n $ s O n
ingrid	" " I N $ g r i: d
evebecksvägen	" " e: $ v e $ b e k s $ % v E: $ g e n
vagnefors	" " v a N $ n e $ % f O s`
silverado	" " s I l $ v e r $ a $ d U
deklarativa	d e $ k l a $ r a $ t i: $ v a
vijahaföde	v I $ d j a $ h a $ " f 2: $ d e
che	s`
uhm	" " }: $ m
mossebergsskolan	" " m O $ s e $ b e r j s $ % s k u: $ l a n
stilspegel	" " s t i: l $ % s p e: $ g e l
måndagsklubben	" " m O n $ d A: g s $ % k l u0 $ b e n
söder	" " s 2: $ d e r
odner	U d $ n e r
mjaa	" m j A:
kä	" k E:
brevutskick	" " b r e: v $ }: t $ % x\ I k
påt	" p o: t
kungstorget	" " k u0 N s $ % t O r $ j e t
tröjer	" " t r 9 $ j e r
skanska	" " s k a n $ s k a
gaterna	" " g A: $ t e $ n` a
enna	" e $ n a
siffrer	" " s I $ f r e r
tesammans	t e $ " s a $ m a n s
quickly	" k v I k $ l Y
mh	m
ekempel	e $ " k e m $ p e l
slipe	" s l i: $ p e
faktist	f a k $ " t I s t
frå	" " f r o:
högra	" " h 2: g $ r a
samme	s a $ m e
take	" t A: $ k e
sta	" " s t a
efterhand	" " e f $ t e r $ % h a n d
pri	p r I
beslutat	b e $ " s l }: $ t a t
andreas	a n $ " " d r e: $ a s
procedurellt	p r U $ s e $ " d }: $ r e l t
chefsavsnitt	" " x\ e: f s $ A: v $ % s n I t
nittinie	n I $ t I $ " " n i: $ e
blett	" b l e t
beredskapsarbetare	b e $ " " r e: d $ s k A: p s $ a r $ % b e: $ t a $ r e
solkraft	" " s u: l $ % k r a f t
ökad	" " 2: $ k a d
ble	b l e
flickerna	" " f l I $ k e $ n` a
helen	h e $ " l e: n
resterande	r e $ " s t e: $ r a n $ d e
erat	e $ " r A: t
sch	" s`
rullera	r u0 $ " l e: $ r a
right	r a j t
syntactic	s Y n $ " t a k $ t I t s'
manniskorna	" m a $ n I $ s k U $ n` a
gnistkammaren	" " g n I s t $ % k a $ m a $ r e n
åresjön	" " o: $ r e $ % x\ 9 n
hundraåttio	" " h u0 n $ d r a $ " O $ t I $ U
tä	t E
siderna	" " s i: $ d e $ n` a
ao	a*U
taste	" t a $ s t e
mellanstad	" " m e $ l a n $ % s t A: d
mittemot	m I $ t e $ m u: t
olskroken	" " U l s $ k r u: $ k e n
funky	" " f u0 N $ k Y
much	" m u0 s`
plantförvaltningen	" " p l A: n t $ f 9 r $ % v a l t $ n I N $ e n
welcome	" " v e l $ k O $ m e
shit	" s` i: t
tr	" t r a
titte	" t I t
katthult	k a t $ h u0 l t
kallops	k a $ " l u: p s
superpling	" " s }: $ p e r $ p l I N
situationsplan	s I $ t }: $ a $ " " x\ u: n s $ % p l A: n
kva	" " k v a
pra	p r a
procedural	p r U $ s e $ " " d }: r $ % A: l
demokratiskt	d e $ m U $ " k r A: $ t I s k t
gi	" g I
landala	" " l a n $ d A: $ l a
ffu	e f $ e f $ " }:
runs	" " r }: n s
here	h e: $ r e
dörrn	" " d 9 n`
uppleve	" " u0 p $ l e: $ v e
uppfalla	" " u0 p $ % f a $ l a
run	" " r }: n
tidiare	" " t i: $ d I $ a $ r e
7.0	x\ u0 $ m $ p e n
seminarie	s e $ m I $ " " n A: $ r I $ e
nydelit	" " n y: $ d e $ " l i: t
asså	a $ " s o:
barntröjerna	" " b A: n` $ t` r 9 $ j e $ n` a
trädgårdar	" t r e $ g o: $ d` a r
pf	" " p e: $ % e f
runtomkring	" " r }: n $ t O m $ k r I N
tj	s'
sjuhund	x\ }: $ h u0 n d
youre	" j o: r
marta	" " m A: $ t` a
ränter	" " r e n $ t e r
tisempel	t I $ " s e m $ p e l
magic	" m A: $ g I t s'
signerad	s I $ " n j e: $ r a d
bahnhof	" b A: n $ h o: f
sjutusen	x\ u0 $ " t }: $ s e n
hundringen	" " h u0 n d $ % r I N $ e n
sannolikhet	" " s a $ n U $ l i: k $ % h e: t
huvudbefattning	" " h }: $ v u0 d $ b e $ % f a t $ n I N
es	" e s
natulitvis	n a $ t u0 $ l I $ % t v i: s
haru	h a r $ " }:
eftermiddage	" " e f $ t e r $ m I $ % d A: $ g e
paso	p a $ s U
naa	" n A:
too	" t o:
planerad	p l a $ " n e: $ r a d
der	d e r
hisingen	" " h I $ s I N $ e n
desse	" d e $ s e
dömd	" d 9 m d
grov	" " g r u: v
eyc	" e j $ " s e:
tjugoåttonde	s' }: $ g U $ " " O $ t O n $ d e
hålle	" " h O $ l e
salures	s a $ " l }: $ r e s
jae	" j A:
tusan	" t }: $ s a n
oc	O k
meaning	m e $ " A: $ n I N
eges	" " e: $ g e s
1.0	" e t p e n
fordonsförsäkring	" " f u: $ d` u: n s $ f 9 $ % s` E: $ k r I N
state	" " s t A: $ t e
idè	i: $ d e: $ " e:
naj	" " n a j
tillexempel	" " t I l $ e k $ % s e m $ p e l
överrens	" " 2: $ v e $ % r a n s
kompledigt	" " k O m p $ l e: $ d I k t
eskil	" " e $ s k I l
verkstäderna	" " v e r k $ % s t E: $ d e $ n` a
människerna	" m e $ n I $ s k e $ n` a
see	" " s i:
hängande	" " h e N $ a n $ d e
car	" k a r
quines	" " k v I $ n e s
dagmammer	" " d A: g $ % m a $ m e r
nedanför	" " n e: $ d a n $ % f 2: r
kante	" k a n $ t e
where	" v E: r
und	" u0 n d
felt	" f e l t
pannhuset	" " p a n $ % h }: $ s e t
nö	" n 9
rolit	r U $ " l i: t
serru	" s e $ r u0
ettusentvåhundratretton	e t $ " t }: $ s e n $ % t v o: $ h u0 n $ d r a $ " " t r e $ t O n
inåt	" " I n $ O t
affärsförhandling	a $ " " f E: s` $ f 9 r $ % h a n d $ l I N
mba	e m $ b e: $ " A:
gater	" " g A: $ t e r
mmh	e m $ e m $ " " h o:
know	" k n O v
jädrigt	" " j E: $ d r I k t
jau	" j a*U
think	" " t I N k
3.5	" t r e: t _ u0
morgonflyg	" " m O r $ g O n $ % f l y: g
nåe	" " n o: $ e
feck	f e k
enskilde	" " e: n $ % x\ I l $ d e
leave	" l i: $ v e
skoler	" " s k u: $ l e r
vicket	" " v I $ k e t
såå	" s o:
titter	" t I $ t e r
olycker	" " u: $ l Y $ k e r
kopparformen	" " k O $ p a r $ % f O r $ m e n
bå	" b o:
jiggera	" j I $ g e $ r a
geck	" g e k
kopplad	" " k O $ p l a d
ini	" i: $ n I
snoopy	" s n U $ p I
tän	" t E: n
neruda	n e $ " r }: $ d a
ocks	" O k s
försej	f 9 $ " s` e j
radioaktiva	" " r A: $ d I $ U $ a k $ " t i: $ v a
barnflicker	" " b A: n` $ % f l I $ k e r
inlärare	" " I n $ % l E: $ r a $ r e
tm	" " t e: $ % e m
mio	m I $ U
gjo	" j u:
elvahundra	" " e l $ v a $ h u0 n $ d r a
vice	" v I s
kän	" k e n
ende	e n $ d e
un	" u0 n
skader	" " s k A: $ d e r
hundrasextio	" " h u0 n $ d r a $ " " s e k $ s t I $ U
atese	a $ " " t s
tjugosjunde	s' }: $ g U $ " " x\ u0 n $ d e
ticker	" t I $ k e r
jajaja	" " j a $ j a $ j A:
vika	" " v i: $ k a
ettusenfyrahundra	e t $ " t }: $ s e n $ " f y: $ r a $ " h u0 n $ d r a
vegan	" " v e: $ g a n
jättesnygga	" " j e $ t e $ % s n Y $ g a
njaä	" n j A: E
sn	" s n
nähe	" " n E:
etthundratjugefem	e t $ h u0 n $ d r a $ s' }: $ g e $ " f e m
kla	" k l a
språkinlärning	" " s p r o: k $ I n $ % l E: $ n` I N
blomsterföreningen	" " b l O m $ s t e r $ f 9 r $ % e: $ n I N $ e n
läxer	" " l e k $ s e r
kumigungan	" k }: $ m I $ % g u0 N $ a n
uti	}: $ t i:
jobbe	" j O $ b e
näa	" " n E: $ a
nåns	" n O n s
macdonalds	m a k $ " d O $ n a l d s
karlaplan	" " k A: $ l` a $ % p l A: n
language	l a N $ " g A: s`
cetera	s e $ " t e: $ r a
jajemen	j a $ " j e: $ m e n
tju	" s' }:
chomsky	" " s' o: m $ s k Y
ol	" u: l
hundratjugefem	" " h u0 n $ d r a $ " " s' }: $ g e $ " f e m
sjä	" " x\ E:
utå	" " }: t $ % o:
ått	O t
rörena	" r 2: $ r e $ n a
hundred	" " h u0 n d $ r e: d
texempel	t e k $ " " s e m $ p e l
avancerad	a $ v a n $ " s e: $ r a d
wanna	" v a $ n a
masthuggskyrkan	" " m a s t $ h u0 g s $ % s' Y r $ k a n
dju	" " j }:
kommunblocket	k O $ " " m }: n $ % b l O $ k e t
tandor	" " t a n $ d O r
nänänä	" " n e $ n e $ n E:
förstörd	f 9 $ " s` t` 2: d`
want	v a n t
frjaa	e f $ e r $ j A:
totalen	t U $ " t A: $ l e n
förvaltningsledningen	f 9 r $ " " v a l t $ n I N s $ % l e: d $ n I N $ e n
översatt	" " 2: $ v e $ % s` a t
misstänksam	" " m I $ s t e N k $ % s a m
djurena	" " j }: r $ e $ n a
skatås	" " s k A: t $ % o: s
dratt	" d r a t
öum	" " 2: $ u0 m
put	" " p u0 t
fungerer	f u0 N $ " g e: $ r e r
trettioförsta	" " t r e $ t I $ U $ " " f 9 $ s` t` a
kräfter	" " k r e f $ t e r
ck	s e: $ k o:
dett	" d e t
kvaliteter	k v a $ l I $ " t e: $ t e r
överhuvetaget	$ 2: $ v e r $ % h }: $ v e $ % t A: $ g e t
6.0	e k $ r e n
nittonhundranittio	" " n I $ t O n $ h u0 n $ d r a $ " n I $ t I $ U
tillverkad	" " t I l $ % v e r $ k a d
three	" t r i:
åttahundratusen	" " O $ t a $ h u0 n $ d r a $ % t }: $ s e n
kuvertmodellen	k }: $ " " v E: r $ m U $ % d e $ l e n
vicken	" " v I $ k e n
inifrån	" " I $ n I $ % f r o: n
saté	s a $ " t e:
olearys	O $ l e $ " A: $ r Y s
battle	b a $ t e l
room	" r u: m
about	a $ " b u:
ver	v e r
plåtslagargatan	p l o: t $ s l A: $ g a r $ % g A: $ t a n
odensås	" " u: $ d e n s $ % o: s
had	" h a d
energikällerna	e $ n e r $ " " x\ i: $ % s' e $ l e $ n` a
rippåsen	" " r i: p $ % p o: $ s e n
borte	" b O $ t` e
aä	a E
never	" " n e: $ v e r
knivsetet	" " k n i: v $ % s e $ t e t
country	" " k a*U n $ t` r I
jaadå	" j A: $ d O
nääe	" n E:
situationsplanen	s I $ t }: $ a $ " " x\ u: n s $ % p l A: $ n e n
sty	" s t Y
tjaba	" s' A: $ b a
kuvertväskorna	k }: $ " " v E: r $ % v e $ s k U $ n` a
macdonald	m a k $ " d O $ n a l d
deo	d e: $ U
revaist	" " r e: $ v a j s t
deskriptivt	d e $ s k r I p $ t i: f t
synkategorematiska	" " s Y N $ k a $ t e $ g U $ r e $ " m A: $ t I $ s k a
kilroy	s' I l $ " r O j
tjugenie	" " s' }: $ g e $ n I
wow	" v O v
mittenhålet	" " m I $ t e n $ % h o: $ l e t
mandrake	m a n $ " d r A: $ k e
kulturbegrepp	k u0 l $ " " t }: r $ b e $ % g r e p
grundhyran	" " g r u0 n d $ % h y: $ r a n
dåå	" d o:
avslutad	" " A: v $ % s l }: $ t a d
fridfullt	" " f r i: d $ % f u0 l t
humboldt	h u0 m $ " b O l t
komero	k O $ m e $ r U
johannebergsskolan	j U $ h a $ n e $ " " b e r j s $ % s k u: $ l a n
någen	" " n o: $ g e n
jätt	" j e t
tvåtusenfemhundra	t v o: $ " " t }: $ s e n $ % f e m $ " h u0 n $ d r a
allefall	" " a $ l e $ % f a l
ettusenfemhundra	e t $ " t }: $ s e n $ " f e m $ " h u0 n $ d r a
vilk	" v I l k
carts	" k A: t` s`
hja	" " j a
then	t e n
dcc	" " d e: $ s e: $ " s e:
könsneutralt	" " s' 2: n s $ n e: $ }: $ % t r A: l t
niohundranitti	n i: $ U $ h u0 n $ d r a $ n I $ t I
plösligt	" " p l 2: $ s l I k t
spruter	" " s p r }: $ t e r
antikmålat	a n $ " " t i: k $ m o: $ l a t
sjuttifem	x\ u0 $ t I $ " f e m
other	U $ " t e r
supercard	" " s }: $ p e r $ " k A: d`
uta	" }: $ t a
voltaren	" " v O l $ t a $ r e n
pricehouse	" p r a j s $ h a $ u0 s
masse	" m a $ s e
gu	" g }:
ace	" e j s
mjo	" " m j u:
nittonhundratrettioett	" " n I $ t O n $ h u0 n $ d r a $ t r e $ t I $ U $ " e t
ere	" E: r
deskriptiva	d e $ s k r I p $ t i: $ v a
trägårn	" t r E: $ g o: n`
bätt	" b e t
ettusensjuhundra	e t $ " t }: $ s e n $ x\ }: $ " h u0 n $ d r a
forces	" f o: r s
sne	" s n e
varsin	" v a $ s` I n
skrämd	" s k r e m d
huvudmannagruppen	" " h }: $ v u0 d $ m a $ n a $ % g r u0 $ p e n
erland	" " E: r $ l` a n d
trestjärnit	" " t r e: $ % x\ E: $ n` I t
telefonummer	t e $ l e $ f U $ % n u0 $ m e r
mühler	" m y: $ l e r
imponerad	I m $ p U $ " n e: $ r a d
volvia	" " v O l $ v I $ a
kristallfontänen	k r I $ " " s t a l $ f O n $ " t E: $ n e n
diablo	d i: $ a $ b l U
now	" n O v
tandläkarn	" " t a n d $ l E: $ k a n`
was	" " v A: s
läre	" " l E: $ r e
poetry	p U $ " e: $ t r Y
mjörn	" " m j 2: n`
skiver	" " x\ i: $ v e r
horse	" " h O $ s` e
skolverksamheten	" " s k u: l $ v e r k $ s a m $ % h e: $ t e n
barndressar	" " b A: n` $ d` r e $ s a r
nydeli	" " n y: $ d e $ l i:
förtiåtta	f 9 $ " t` i: $ " " O $ t a
löpa	" " l 2: $ p a
nte	e n $ t e
härn	" " h E: n`
mose	" " m u: $ s e
backpacker	" " b a k $ % p a $ k e r
kategorematiska	k a $ t e $ g U $ r e $ " m A: $ t I $ s k a
bush	" " b u0 s`
trehålan	" " t r e: $ % h o: $ l a n
omgående	" " O m $ % g o: $ e n $ d e
malin	m a $ " l i: n
luggage	" " l u0 g I t s'
kvalificerad	k v a $ l I $ f I $ " s e: $ r a d
zamenhof	s a $ " m e: n $ h o: f
kopparsilen	" " k O $ p a $ s` I $ l e n
dähär	" " d E: E: r
riktit	" " r I k $ t I t
mänsker	" " m e n $ x\ e: r
fu	" f u0
studentbiljett	s t }: $ " " d e n t $ b I l $ % j e t
gre	" g r e
ice	" i: s
docker	" " d O $ k e r
tänke	" " t e N $ k e
kallebäck	" " k a $ l e $ b e k
prove	" " p r u: $ v e
trett	" " t r e t
anything	" " a $ n j t I N
mycka	" " m Y $ k a
gabben	" g a $ b e n
fasettslipat	f a $ " " s e t $ % s l i: $ p a t
dont	" d o: n t
old	" " O l d
plupparna	" " p l u0 $ p a $ n` a
tjugoförste	s' }: $ g U $ " " f 9 $ s` t` e
vilse	" " v I l $ s e
otäcka	" " u: $ % t e $ k a
konstgödsel	" " k O n s t $ g 9 t $ s e l
everything	" " e: $ v e $ % r y: t I N
goddag	g u: d $ " d A: g
voucher	" " v U $ s` e r
lö	" l 2:
going	g U $ I N
aus	" o: s
plastficker	" " p l a s t $ % f I $ k e r
face	" f e j s
mary	m a $ r I
fungerande	f u0 N $ " g e: $ r a n $ d e
ce	s
semjanmattan	" " s e: $ m j a n $ % m a $ t a n
hiffla	" h I $ f l a
slipmedel	" " s l i: p $ % m e: $ d e l
lärarn	" " l E: r $ a n`
stot	" " s t o: t
språkinstitutionerna	" " s p r o: k $ I n $ s t I $ t }: $ % x\ u: $ n e $ n` a
pco	p e: $ s e: $ " u:
varierande	v a $ r I $ " e: $ r a n $ d e
programpaket	p r U $ " " g r a m $ p a $ % k e: t
noggranna	" " n u: $ % g r a $ n a
adbkontoret	A: $ d e: $ " b e: $ k O n $ % t u: $ r e t
mittborg	" " m I t $ % b O r j
were	" " v E: r
bruksanvisning	" " b r }: k s $ a n $ % v i: $ s n I N
niehundrafemtio	" n i: $ " h u0 n $ d r a $ f e m $ t I $ U
please	p l i: s
hundrafem	" " h u0 n $ d r a $ " f e m
ingmyr	" " I N $ m y: r
plastgrejen	" " p l a s t $ % g r e $ j e n
pover	" p o: $ v e r
skyddad	" " x\ Y $ d a d
råvarer	" " r o: $ v A: $ r e r
gg	g
kansk	" k A: n s k
ersättningsbesked	" " e: $ s` e t $ n I N s $ b e $ % x\ e: d
exem	e k $ " " s e m
ford	f O d`
which	" v I t s'
socialistisk	s U $ s I $ a $ % l I $ s t I s k
more	" " m o: $ r e
lövgärdet	" " l 2: v $ % j E: $ d` e t
verne	" v E: $ n` e
uppstrand	" " u0 p $ % s t r a n d
språkval	" " s p r o: k $ % v A: l
hun	" h }: n
annorstad	" " a $ n U $ % s` t` A: d
fyrahundratusen	f y: $ r a $ h u0 n $ d r a $ % t }: $ s e n
avtalshotell	" " A: v $ t A: l s $ h U $ % t e l
giggling	" " j I $ g l I N
fjällbysjön	" " f j e l $ b y: $ % x\ 9 n
äl	E: l
pensionärstaxa	p a N $ x\ U $ " " n E: s` $ % t` a k $ s a
stensprängare	" " s t e: n $ % s p r e N $ a $ r e
naturstigar	n a $ " " t }: $ % s` t` i: $ g a r
guldhedsskolan	" " g u0 l d $ h e: d s $ % s k u: $ l a n
astrud	a $ " s t r }: d
styckna	" " s t Y $ k n a
blommerna	b l U $ m e $ n` a
olyckligt	" " u: $ % l Y $ k l I k t
tvåtusentalet	t v o: $ " " t }: $ s e n $ % t A: $ l e t
tillhörande	" " t I l $ % h 2: $ r a n $ d e
something	" s O $ m e t I N
brufen	b r }: $ f e n
joodå	" j u: $ d O
prologprogram	p r U $ " l o: g $ p r U $ % g r a m
they	" t I
privativa	p r I $ v a $ " t i: $ v a
nikol	n I $ " k o: l
plastic	" p l a $ s t I k
ofte	" " O f $ t e
tårnedå	" " t o: $ % n` e: $ d O
poemoj	p U $ e $ " " m O j
need	" " n e: d
klarer	" " k l A: $ r e r
saab	" " s A: b
fascinerad	f a $ s` I $ " n e: $ r a d
taxerna	" " t a k $ s e $ n` a
breakfast	" b r e j k $ % f a s t
little	l I $ t e l
taj	" " t a j
th	t
moberg	" " m u: $ % b e r j
skrivan	" " s k r i: $ v a n
oe	" " u: $ e
varer	" v A: $ r e r
artonhundra	" " A: $ t` O n $ h u0 n $ d r a
over	" " u: $ v e r
stu	" " s t u0
möjlit	" " m 9 j $ l I t
six	s I k s
pån	" p o: n
samlad	" " s a m $ l a d
huh	" h }: x\
distriktsköterskan	d I $ " " s t r I k t s $ % x\ 2: $ t e $ s` k a n
slottskogen	" " s l O t s $ % s k u: $ g e n
djurgårn	" " j }: r $ g o: n`
eum	e: $ u0 m
igungan	I $ " g u0 N $ a n
tjugetusen	" " s' }: $ g e $ " t }: $ s e n
bortåt	" " b O t` $ o: t
them	" t e m
base	" " b e j s
des	" d e s
ekmanska	" " e: k $ % m A: n $ s k a
torsda	" " t u: s` $ d` A:
säjerr	" s e $ j e r
tgoj	t I $ " g O j
barntröja	" " b A: n` $ % t` r 9 $ j a
åhlens	o: $ l e n s
advanced	a $ d v a N $ e d
naturutvecklingen	n a $ " " t }: r $ }: t $ % v e $ k l I N $ e n
hundrafyrtio	" " h u0 n $ d r a $ " f 9 $ t` I $ U
gräsmatter	" " g r E: s $ m a $ t e r
ebony	e $ b U $ " " n y:
seloken	s e $ " l u: $ k e n
vilisics	v I $ " l i: $ s I k s
studentkort	s t }: $ " " d e n t $ % k U t`
nietusen	n I t }: $ s e n
rej	" " r e j
varandre	v a $ " r a n $ d r e
höh	" " h 2: $ % h o:
pre	p r e
igeba	I $ " " j e $ b a
first	" " f 2: s` t`
örgrytehemmet	" " 2: r $ g r y: $ t e $ % h e $ m e t
bilhyra	" " b i: l $ % h y: $ r a
höre	" " h 2: $ r e
malmöavisen	" " m a l $ m 9 $ A: v $ % i: $ s e n
antikmålade	a n $ " " t i: k $ m o: $ l a $ d e
kostchef	" " k O s t $ % x\ e: f
ri	" r i:
kruker	" " k r }: $ k e r
upple	" " u0 p $ l e
komunikado	" " k u: $ % m }: $ n I $ " " k A: $ d U
åe	" " o: $ e
koncentrerad	k O n $ s e n $ " t r e: $ r a d
tjöta	" s' 2: $ t a
bohushälsan	" " b u: $ h }: s $ % h e l $ s a n
np	e n $ p e:
måloförenligheten	" " m o: l $ O $ f 9 r $ " e: n $ l I g $ % h e: $ t e n
självförsörjande	" " x\ e l v $ f 9 $ % s` 9 r $ j a n $ d e
naturkultur	n a $ " " t }: r $ k u0 l $ % t }: r
utdragsbord	" " }: t $ d r A: g s $ % b u: d`
sextonhundra	" " s e k $ s t O n $ h u0 n $ d r a
kungsleden	" " k u0 N s $ % l e: $ d e n
fridlysta	" " f r i: d $ % l y: $ s t a
strumper	" " s t r u0 m $ p e r
resultatbonus	r e $ s u0 l $ " " t A: t $ b u: $ n u0 s
öppe	9 $ p e
tjufjärde	" " s' }: $ f j E: $ d` e
hurpass	h }: $ r }: $ " " p a s
kombikniven	" " k O m $ b I $ % k n i: $ v e n
tillsempel	t I l $ " " s e m $ p e l
försenad	f 9 $ " s` e: $ n a d
gugg	g u0 g
sanflex	s a n $ f l e k s
våger	" " v o: $ g e r
ändrad	" e n $ d r a d
abba	a $ b a
välkommna	" " v E: l $ % k O m $ n a
try	" " t r y:
phuket	" p u0 $ k e t
kaker	" " k A: $ k e r
universalkniven	u0 $ n I $ v e $ " " s` A: l $ % k n i: $ v e n
predikation	p r e $ d I $ k a $ " x\ u: n
bidjarmatta	" b I d $ " j A: r $ % m a $ t a
manniskor	" m a $ n I $ s k U r
algonat	a l $ g U $ " n A: t
textbehanning	" " t e k s t $ b e $ % h a $ n I N
förädlad	f 9 r $ " E: d $ l a d
kafè	k a f $ " e:
betale	b e $ " t A: $ l e
use	}: $ e s $ " e:
renitec	r e $ " " n I $ t e k
harrisburg	" " h a $ r I s $ b u0 r j
noggrann	" " n u: $ g r a n
bluttj	" " b l }: t $ % s'
väskena	" " v e $ s k e $ n a
pot	" p o: t
hemvideo	" " h e m $ v i: $ d e $ U
levaxin	l e $ " v a k $ " s i: n
money	m O $ " n e j
kvack	k v a k
övernatur	" " 2: $ v e $ n` a $ % t }: r
hålingen	" " h o: $ l I N $ e n
wars	" " v A: s`
change	s' a N $ e
memo	m e $ m U
malayerna	" " m A: $ l a $ j e $ n` a
kulturbundet	k u0 l $ " " t }: r $ % b u0 n $ d e t
leanders	l e $ " " a n $ d e s`
kommunalkamrern	k O $ m }: $ " " n A: l $ k a m $ " r e: n`
uea	}: $ " " e: $ % A:
fylld	" f Y l d
tietusen	" t I $ e $ t u0 $ s e n
kungsportsplatsen	" " k u0 N s $ % p U t` s` $ % p l a t $ s e n
fattes	" " f a $ t e s
brö	" b r 2:
tjufemte	s' u0 $ " " f e m $ t e
ettusensexhundra	e t $ " t }: $ s e n $ % s e k s $ " h u0 n $ d r a
hash	" " h a s`
intuitioner	I n $ t }: $ I $ " x\ u: $ n e r
posom	p U $ " s o: m
höjda	" " h 9 j $ d a
anvä	" " a n $ v E
gustaviskolan	g u0 $ s t a $ v I $ % s k u: $ l a n
inn	" " I n
tvingad	" " t v I N $ a d
föresten	" " f 2: $ r e $ s t e n
elverksföreningen	" " e: l $ v e r k s $ f 9 r $ % e: $ n I N $ e n
afd	a f $ " t
yeah	" j e:
varsegoda	" " v A: $ s` e $ % g u: $ d a
uppkomsthistorien	" " u0 p $ k O m s t $ h I $ % s t u: $ r I $ e n
inlastningsrummet	" " I n $ % l a s t $ n I N s $ % r u0 $ m e t
deprimerad	d e $ p r I $ " m e: $ r a d
unan	" " }: $ n a n
gä	" g E:
jahaja	j a $ h a $ j a
framställd	" " f r a m $ % s t e l d
solvej	s O l $ " v e j
stay	" s t e j
enminutare	" " e: n $ m I $ n }: $ t a $ r e
tavler	" " t A: v $ l e r
tolvtusen	" " t O l v $ t u0 $ s e n
öss	9 s
burås	" " b }: $ % r o: s
utanpå	" " }: $ t a n $ p o:
night	" n i: g t
förvirrande	f 9 r $ " v I $ r a n $ d e
macker	" m a $ k e r
posomgrupp	p U $ " s o: m $ % g r u0 p
piron	p I $ " r o: n
tillsatt	" " t I l $ % s a t
name	" n e j m
vänter	" v e n $ t e r
og	O g
avhandlat	" " A: v $ % h a n d $ l a t
stabunn	s t a $ " b u0 n
oroad	" " u: $ % r u: $ a d
br	b e: $ e r
affärn	a $ " f E: n`
stopplinjen	" " s t O p $ % l i: $ n j e n
neä	" n j E
5.0	u0 $ t e $ r e n
eight	" " e $ j t
fair	" f E: r
jahaa	j A: $ " h A:
mean	m e $ " a n
inbakat	" " I n $ % b A: $ k a t
inunder	I $ " n u0 n $ d e r
zilah	s i: $ " l a
ähä	e $ h E
taxer	" " t a k $ s e r
english	e N $ " l I s`
but	" b }: t
kommunhälsan	k O $ " " m }: n $ % h e l $ s a n
väldi	" " v E: l $ d I
kostnadsställe	" " k O s t $ n a t s $ % s t e $ l e
runtom	" " r }: n $ % t U m
gvt	g f t
andraspråksinlärning	" " a n $ d r a $ % s p r o: k s $ I n $ % l E: $ n` I N
ämneslärarlinjen	$ e m $ n e s $ % l E: $ r a $ % l` i: $ n j e n
inni	" " I $ n I
jäpp	" j e p
thee	" t e: $ e
männskan	" m e n $ s k a n
loggfilen	" " l O g $ % f i: $ l e n
odlad	" " u: d $ l a d
häh	" " h E:
distriktslantmätaren	d I $ " " s t r I k t s $ l a n t $ % m E: $ t a $ r e n
hörrö	" h 9 $ r 2:
igentlien	I $ " " j e n $ t e l $ j e n
boendehem	" " b u: $ e n $ d e $ % h e m
äti	" E: $ t I
hundratrettio	" " h u0 n $ d r a $ t r e $ t I $ U
varuförteckningen	" " v A: $ r }: $ f 9 $ % t` e $ k n I N $ e n
deixis	d e $ " I k $ s I s
skreve	" s k r e: $ v e
hårshampo	" " h o: $ % x\ a m $ p U
oljemåningen	" " O l $ j e $ m o: $ n I N $ e n
rumsfunktionsprogram	" " r u0 m s $ f u0 N k $ " " x\ u: n s $ p r U $ % g r a m
past	" p a s t
skoboard	" " s k u: $ % b o: d`
oft	O f t
muroj	" " m }: r $ O j
tomteland	" " t O m $ t e $ % l a n d
panki	" " p a N $ k I
chocking	" " x\ O $ k I N
uppodlat	" " u0 p $ % u: d $ l a t
avs	" " A: v s
månda	" m O n $ d a
accepterad	a k $ s e p $ " t e: $ r a d
damväsker	" " d A: m $ % v e $ s k e r
vecke	" " v e $ k e
quine	" k v I n
fullstrand	" " f u0 l $ % s t r a n d
turlasson	" " t }: r $ % l` a $ s O n
ääm	E: m
hjä	" j E:
putser	" p u0 t $ s e r
präglad	" " p r E: $ g l a d
tlg	t e: $ e l $ " g e:
viller	" " v I $ l e r
tretusenetthundra	" " t r e: $ t }: $ s e n $ % e t $ " h u0 n $ d r a
innersvets	" " I $ n e $ % s` v e: t s
mässer	" m e $ s e r
implementerat	I m $ p l e $ m e n $ % t e: $ r a t
youth	" j a*U t
flames	f l a $ " m e: s
fehrid	" f e: $ r I d
sve	" s v
ellitas	" e $ l I $ t a s
förd	" f 2: d`
sjuhun	x\ }: $ h u0 n
blyton	" " b l y: $ % t u: n
emotionella	e $ m U t $ x\ U $ " n e $ l a
uppemot	" " u0 $ p e $ m u: t
bruker	" b r }: $ k e r
byggsmart	" " b Y g $ % s m A: t`
altså	" " a l t $ % s O
luvtröja	" l }: v $ % t r 9 $ j a
medecin	" " m e: $ d e $ s I n
bajsat	" " b a j $ s a t
därf	d e r $ " e f
korczak	" k O r k $ s a k
auxtoro	a*U k $ " t o: $ r U
gold	" g O l d
dildos	" d i: l $ d U s
flasker	" " f l a $ s k e r
brandkonsult	" " b r a n d $ k O n $ % s u0 l t
hurdant	" h }: $ d` a n t
anyway	" " a $ n j $ v e j
hjälpvagnsbefälhavare	" " j e l p $ v a N n s $ b e $ f E: l $ % h A: $ v a $ r e
inpandern	" " I n $ p a n $ d e n`
holms	" h O l m s
kärnkraftsutbyggnad	" " s' E: n` $ k r a f t s $ }: t $ % b Y $ g n a d
catch	" k e t s'
jobber	" j O $ b e r
tomtebo	" " t O m $ t e $ % b u:
konceptoj	k O n $ " " s e p t $ % O j
psykolingvistisk	p s Y $ k U $ " " l I N $ " v I $ s t I s k
flajt	" f l a j t
vat	" v A: t
kat	" k A: t
sjuttisex	x\ u0 $ t I $ " s e k s
oho	" " u: $ % h u:
oops	" " u: $ O p s
redbergsplatsen	" " r e: d $ b e r j s $ % p l a t $ s e n
fastställda	" " f a s t $ % s t e l $ d a
seek	" " s i: k
sugatex	" " s }: $ g a $ t e k s
bondespelet	" " b U n $ d e $ % s p e: $ l e t
sexhund	s e k s $ h u0 n d
tänkta	" " t e N k $ t a
berggrundgatan	" " b e r j $ % g r u0 n d $ % g A: $ t a n
sjöbåt	" " x\ 2: $ % b o: t
bordlägger	" " b u: d` $ % l` e $ g e r
kemikalier	s' e $ m I $ " " k A: $ l I $ e r
sweet	" s v e: $ e t
ine	" i: $ n e
videre	v I $ " d e: $ r e
prob	p r U $ " b e:
procedure	p r U $ s e $ " d }: $ r e
10.0	" e t u: $ r e n
sextontiden	" " s e k $ s t O n $ % t i: $ d e n
sls	" s l s
ikans	I $ " k A: n s
thousand	" t u: $ s a n d
intrasubjektivt	" " I n $ % t r A: $ s u0 $ b j e k $ t i: f t
sna	" s n a
kärnordförråd	" " s' E: n` $ % u: d` $ f 9 $ % r o: d
sparkad	" " s p a r $ k a d
tjuåttonde	s' u0 $ " " O $ t O n $ d e
göret	" " j 2: $ r e t
spegelbyrån	" " s p e: $ g e l $ % b y: $ r o: n
persone	p e $ " s` u: $ n e
okä	" " u: $ % s' E:
jävli	" " j E: v $ l I
nollsju	" " n O l $ " x\ }:
bc	" " b e: $ % s e:
höner	" " h 2: $ n e r
härnt	" " h E: n` t`
skafsta	" s k a f $ s t a
energislagen	e $ n e r $ " " x\ i: $ % s l A: $ g e n
lasix	l a $ " s I k s
fyratusenfyrahundratre	" " f y: $ r a $ t }: $ s e n $ % f y: $ r a $ " h u0 n $ d r a $ " t r e:
hållarn	" " h O $ l a n`
männsker	" m e n $ s k e r
ficken	" " f I $ k e n
stenhårt	" " s t e: n $ % h o: t`
kapsylöppnare	k a p $ " s y: l $ % 9 p $ n a $ r e
gamlestan	" " g a m $ l e $ s t a n
aletisk	a $ " l e: $ t I s k
lagerresurser	" " l A: $ g e r $ r e $ % s u0 $ s` e r
trettioförste	" " t r e $ t I $ U $ " " f 9 $ s` t` e
bokenäset	" " b u: $ k e $ % n E: $ s e t
ke	" k e
insekter	" " I n $ % s e k $ t e r
slo	s l U
genomtänkta	" " j e: $ n O m $ % t e N k $ t a
skolerna	" " s k u: $ l e $ n` a
damn	" " d a m n
årsanställda	o: s` $ a n $ % s t e l $ d a
rosberga	" " r u: s $ % b e r $ j a
ent	e n t
seja	" " s e $ j a
häringa	" " h E: $ r I N $ a
ugland	" " }: $ % g l a n d
industrialiserat	I n $ d u0 $ s t r I $ a $ l I $ " s e: $ r a t
förundersökningsprotokollet	" " f 2: r $ u0 n $ d e $ % s` 2: $ k n I N s $ p r U $ t U $ % k O $ l e t
espero	e $ s p e $ r O
jordbruksland	" " j u: d` $ b r }: k s $ % l a n d
sanningsbevarande	" " s a $ n I N s $ b e $ % v A: $ r a n $ d e
hålogik	" " h o: $ l U $ " g i: k
ef	e f
way	" v e j
femhålan	" " f e m $ % h o: $ l a n
hotellnätter	h U $ " " t e l $ % n e $ t e r
energibrist	e $ n e r $ " " x\ i: $ % b r I s t
schackdator	" " x\ a k $ % d A: $ t U r
möjl	" " m 9 j $ l
martins	" " m a $ t` I n s
jaah	" " j A: $ a
remsedel	" " r e m $ % s e: $ d e l
härigem	" h E: r $ I $ j e: m
hörre	" h 9 $ r e
sämst	" s e m s t
utanborg	" " }: $ t a n $ b O r j
friday	f r I $ d e j
jabbadabbado	" " j a $ b a $ a $ b a $ d U
rappbergs	" " r a p $ % b e r j s
dålit	" " d o: $ l I t
bergskungahuset	" " b e r j s $ k u0 N $ a $ % h }: $ s e t
trettiofemtusen	" " t r e $ t I $ U $ " " f e m $ " t }: $ s e n
kostchefer	" " k O s t $ % x\ e: $ f e r
bisse	" " b I s
frågeord	" " f r o: $ g e $ % u: d`
programme	" p r u: $ g r a $ m e
däj	" d e j
cash	k a s`
nittonhundrasexti	" " n I $ t O n $ h u0 n $ d r a $ s e k $ s t I
heej	h e $ " e j
ill	" " I l
mongos	m O N $ g U s
buråsskolan	" b 2: r $ o: s $ % s k u: $ l a n
utsänt	" " }: t $ % s e n t
enterer	" " e: n $ t e r $ e r
hundrasextiofem	" " h u0 n $ d r a $ " " s e k $ s t I $ U $ " f e m
ankeborgs	a N $ k e $ " b O r j s
vrravrre	" v r r e j v $ r e
sti	" s t I
say	" s e j
psykolingvistiska	p s Y $ k U $ " " l I N $ " v I $ s t I $ s k a
etthundratjuge	e t $ h u0 n $ d r a $ s' }: $ g e
torento	t U $ " " r e: n $ t U
uppkomsthistoria	" " u0 p $ k O m s t $ h I $ % s t u: $ r I $ a
överlapp	$ 2: $ v e $ % l` a p
restresa	" " r e s t $ % r e: $ s a
närå	" " n E: r $ % o:
war	" " v a r
åhåhå	" " o: $ h o: $ " h o:
anv	a n $ " v e:
nittonhundraåttio	" " n I $ t O n $ h u0 n $ d r a $ " O $ t I $ U
utveck	" " }: t $ % v e k
foreign	f O $ " r e j n
nähähä	n e $ h e $ h E
vär	" " v E: r
jasidans	" " j A: $ % s i: $ d a n s
tvåtusentvåhundra	t v o: $ " " t }: $ s e n $ % t v o: $ " h u0 n $ d r a
lexical	l e k $ s I $ " k A: l
litte	l I $ t e
svetse	" s v e t $ s e
zweibergk	" s v e j $ b e r j k
resekungen	" " r e: $ s e $ % k u0 N $ e n
tummeliten	t u0 $ m e $ % l i: $ t e n
tretusenfyrahundra	" " t r e: $ t }: $ s e n $ % f y: $ r a $ " h u0 n $ d r a
åttionie	" " O $ t I $ O $ n I
hölle	" " h 9 $ l e
conflict	k O n $ f l I k t
fakt	f a k t
security	s e $ " k }: $ r I $ t Y
kopparform	" " k O $ p a r $ % f O r m
uppfallasjön	" " u0 p $ f a l $ a $ % x\ 9 n
medeciner	m e $ d e $ " s i: $ n e r
byggnadsföreningen	" " b Y $ g n a t s $ f 9 r $ % e: $ n I N $ e n
fle	f l e
franca	" f r a N $ k a
öt	2: t
inlämningskvittot	" " I n $ l e m $ n I N s $ % k v I $ t U t
sener	" " s e: $ n e r
blan	b l a n
caramba	k a $ r a m $ b a
ånäsfältet	" " o: $ n E: s $ % f e l $ t e t
ant	" a n t
hälsovårdsordning	" " h e l $ s U $ v o: d` s` $ % o: d` $ n` I N
ordena	" o: $ d` e $ n a
fl	" " e f $ e l
använ	" " a n $ % v e n
until	}: $ e n $ " t i: l
beslutade	b e $ " " s l }: $ t a $ d e
svare	" s v A: $ r e
äuh	O j
rinnande	" " r I $ n a n $ d e
technical	t e $ " k n I $ k a l
uppbyggd	" " u0 p $ % b Y g d
sexkantiga	" " s e k s $ % k a n $ t I $ g a
probably	p r U $ " b A: $ b l y:
framställda	" " f r a m $ % s t e l $ d a
homelands	h U $ m e $ % l a n d s
strukturalistena	s t r u0 k $ t }: $ r a $ " l I $ s t e $ n a
skä	" s k E
nicht	" n I $ k t
tvåhundratjugefem	t v o: $ h u0 n $ d r a $ s' }: $ g e $ " f e m
teshirten	t e $ " s` 2: $ t` e n
tvärtemot	" " t v E: r $ t e $ m u: t
samle	" " s a m $ l e
tat	t a t
orginalmunstycke	O r $ g I $ " " n A: l $ m u0 n $ % s t Y $ k e
crowns	" k r a*U n s
tek	" t e: k
vv	" " v e: $ % v e:
army	a r $ " " m y:
falantaj	f a $ l a N $ " t a j
tvugna	" " t v u0 N $ n a
möj	" " m 9 j
ingrids	" " I N $ g r i: d s
uthyrningsverksamheten	" " }: t $ h y: $ n` I N s $ v e r k $ s a m $ % h e: $ t e n
sdf	e s $ d e: $ " e f
utsuget	" " }: t $ % s }: $ g e t
flötte	" " f l 9 $ t e
allti	a l $ t I
stä	" s t E
ondersson	" " U n $ d e $ s` O n
besvärsavdelningen	b e $ " " s v E: s` $ A: v $ % d e: l $ n I N $ e n
skolo	" " s k u: $ l U
fullmäktiges	" " f u0 l $ m e k $ t I $ g e s
buråsgården	" b 2: r $ o: s $ % g o: $ d` e n
bastegård	" " b a $ s t e $ % g o: d`
tyt	" t Y t
roomservice	" r u: m $ % s 9 r $ v I s
sandi	" " s a n $ d I
joj	" j O j
fakturer	f a k $ " t }: $ r e r
alfred	" " a l $ f r e: d
mapper	" m a $ p e r
hejhej	h e j $ " h e j
skattkammarallén	" " s k a t $ k a $ m a r $ a $ % l e: n
risinge	" " r i: $ s I N $ e
pay	" p e j
jaaa	" j A: $ a
förberedda	" " f 2: r $ b e $ % r e $ d a
veterligt	" " v e: $ t e $ l` I k t
facts	f a k t s
warzone	v a $ " s` u: n
ympar	" " Y m $ p a r
perfect	p e r $ " f e k t
egenklien	" " e: $ g e n $ k l I $ e n
fegt	" f e: g t
fillippa	" f I $ l I $ p a
familjeomsorgen	f a $ " " m I l $ j e $ O m $ % s O r $ j e n
hadd	" h a d
dää	" d E:
bongar	" " b O N $ a r
planterad	p l a n $ " t e: $ r a d
walldorf	" v a l $ d O r f
mångas	" " m O N $ a s
nämda	" " n e m $ d a
placerad	p l a $ " s e: $ r a d
hundratrettioen	" " h u0 n $ d r a $ t r e $ t I $ U $ " e n
rosenthal	" " r u: $ s e n $ t A: l
gl	" g l
hushållskniv	" " h }: s $ h O l s $ % k n i: v
tmu	t e: $ e m $ " }:
spelledarskärmen	" " s p e: l $ l e: $ d a r $ % x\ e r $ m e n
jen	" j e n
värpt	" v e r p t
princi	p r I n $ " s i:
mante	" " m a N $ t e
tydlien	" " t y: d $ l I $ e n
nine	n I n
dying	" " d y: $ I N
turtagande	" " t }: $ % t` A: $ g a n $ d e
porno	p O $ n` U
kvi	" " k v i:
jaå	" " j A: $ % o:
lito	l I $ t U
säke	" " s E: $ k e
vintägg	" " v I n t $ % e g
called	" " k A: l $ % l e: d
jösses	" " j 9 $ s e s
arbe	" " a r $ b e:
jh	" j
jättekäckt	" " j e $ t e $ % s' e k t
såvikumigungan	s o: $ " " v i: $ k }: $ m I $ % g u0 N $ a n
mahal	m a $ " h A: l
dudek	" d }: $ d e k
smådefekter	" " s m o: $ d e $ f e k $ t e r
femhund	f e m $ h u0 n d
seminarierna	s e $ m I $ " " n A: $ r I $ e $ n` a
dungeon	" " d u0 N $ e $ O n
alles	a $ l e s
hillstorp	h I l s $ % t O r p
vettö	" " v e t $ % 2:
tjoho	" " s' u: $ h U
däringa	" d E: $ r I N $ a
ettfemtio	" " e t $ " f e m $ t I $ U
inna	I $ n a
kravprofil	" " k r A: v $ p r U $ % f i: l
rikkesväg	" " r I $ k e s $ % v E: g
sextisex	" " s e k s $ t I $ " s e k s
naturmedeciner	n a $ " " t }: r $ m e $ d e $ " s i: $ n e r
gallerin	g a $ l e $ " r i: n
arbetsledarträffen	" " a r $ b e: t s $ % l e: $ d a $ t` r e $ f e n
vilke	" " v I l $ k e
come	" " k o: $ m e
söksystem	" s 2: k $ s Y $ % s t e: m
really	r e $ " " A: l $ l Y
picken	" p I $ k e n
unu	" " }: $ n u0
kate	" k E: t
ahh	a
kuusamo	" k }: $ s a $ % m u:
njaaa	" n j A: a
hemtjänstassistenterna	" " h e m $ s' e n s t $ a $ s I $ % s t e n $ t e $ n` a
undertecknad	" " u0 n $ d e $ % t` e $ k n a d
förbättrad	f 9 r $ " b e $ t r a d
därborte	d e r $ " " b O $ t` e
europe	E*U $ r U $ p
beslutande	b e $ " " s l }: $ t a n $ d e
forsmarken	" " f O s` $ % m a r $ k e n
peak	" p i: k
vride	" " v r i: $ d e
wao	v a $ " u:
dangård	" " d A: n $ % g o: d`
höller	" " h 9 $ l e r
gradvis	" " g r A: d $ % v i: s
niehund	" " n i: $ % h u0 n d
liljeskog	" " l I l $ j e $ % s k u: g
vuxnas	" " v u0 k $ s n a s
ladin	l a $ " d i: n
lagena	" l A: $ s` e $ n a
alu	" " A: $ l }:
naturskönhet	n a $ " " t }: r $ % x\ 2: n $ % h e: t
humanvetenskap	h }: $ " " m A: n $ v e $ t e n $ % s k A: p
plastploppen	" " p l a s t $ % p l O $ p e n
syrer	" " s y: $ r e r
polemaisk	p U $ l e $ " m A: $ I s k
förutsäja	" " f 2: r $ }: t $ s e $ j a
inkopplad	" " I n $ % k O $ p l a d
mum	" m u0 m
kapitolo	k a $ p I $ " " t u: $ l U
åljud	" " o: $ % j }: d
bykafors	" " b y: $ k a $ " f O s`
kvetter	k v e $ t e r
intercity	I n $ t e $ " " s` I $ t Y
barnskolan	" " b A: n` $ % s` k u: $ l a n
ruäh	r }: $ " " E:
rift	" r I f t
kicksport	" " k I k $ % s p O t`
personförsäkring	p e $ " " s` u: n $ f 9 $ % s` E: $ k r I N
tbt	t e: $ b e: $ " t e:
strukturerad	s t r u0 k $ t }: $ % r e: $ r a d
skarver	" " s k a r $ v e r
kunst	" k u0 n s t
hehe	h e $ h e
filekniv	" " f i: $ l e $ % k n i: v
programstommar	p r U $ " " g r a m $ % s t U $ m a r
schj	x\
vick	" v I k
tusentrettio	" " t }: $ s e n $ t r e $ t I $ U
peace	" p i: s
förenklad	f 9 r $ " e N $ k l a d
förmiddage	" " f 2: r $ m I $ % d A: $ g e
stafflit	s t a $ " f l i: t
bortanför	" " b O t` $ a n $ % f 2: r
såfall	s o: $ " f a l
nehe	n e $ " h e
överbokat	$ 2: $ v e r $ % b u: $ k a t
presse	" " p r e s $ s e
javesst	j a $ " v e s t
börjer	" " b 9 r $ j e r
rappenbergs	" r a $ p e n $ % b e r j s
geiron	" " g e j $ r O n
kri	" k r i:
trap	" t r a p
härigemer	" h E: r $ I $ j e: $ m e r
krämper	" " k r e m $ p e r
def	d e f
boack	" " b u: $ a k
tätknuten	" " t E: t $ % k n }: $ t e n
programsystem	p r U $ g r a m $ s Y $ % s t e: m
kolsvarten	" " k o: l $ % s v a $ t` e n
sittande	" " s I $ t a n $ d e
njä	" n j E:
bannsåga	" " b a n $ % s o: $ g a
anpassad	" " a n $ % p a $ s a d
expensive	e k $ " s p e n $ " s i: $ v e
koterna	" " k u: $ t e $ n` a
number	n u0 m $ b e r
cornetto	k O $ " n` e $ t U
karlsorden	" " k A: l` s $ % u: $ d` e n
garderobsskåp	g a $ d` e $ " " r o: b s $ % s k o: p
borelia	b U $ " r e: $ l I $ a
skullle	" s k u0 l $ l e
kulturkrafter	k u0 l $ " " t }: r $ % k r a f $ t e r
artonårig	" " A: $ t` O n $ % o: $ r I g
bvitaminen	b e $ v I $ t a $ % m i: $ n e n
mistero	" " m I $ s t e $ r U
djurintresse	" " j }: r $ I n $ % t r e $ s e
taxonomi	" " t a k $ s U $ n U $ " m i:
dodo	d O $ d O
coming	" " k o: $ m I N
betax	b e $ " t a k s
beng	" " b e N
huvetaget	" " h }: $ v e $ % t A: $ g e t
trek	t r e: $ " k o:
nittonhundrasextinie	" " n I $ t O n $ h u0 n $ d r a $ s e k $ s t I $ n I
femhåling	f e m $ " h o: $ l I N
igengrötad	I $ " " j e N $ % g r 2: $ t a d
töcker	" t 9 $ k e r
blidde	" b l I $ d e
sånhära	" s O n $ h e $ r a
berggren	" " b e r j $ % g r e: n
attention	a $ t e n $ " x\ u: n
språkfilosofer	" " s p r o: k $ f I $ l U $ % s o: $ f e r
cashcrops	k a $ " s` k r u: p s
sprir	" s p r i: r
outside	" " a*U t $ s a j d
tjugelappen	" " s' }: $ g e $ % l a $ p e n
lipp	" l I p
deu	" d j u:
åtalad	$ o: $ % t A: $ l a d
constructs	k O n $ s t r u0 k t s
samfond	" " s a m $ % f O n d
members	m e m $ b e s`
telma	" " t e l $ m a
civilkurage	s I $ " " v i: l $ k }: $ % r A: s`
tjugifem	" " s' }: $ g I $ " f e m
kulresor	" " k }: l $ % r e: $ s U r
billiaste	" " b I $ l I $ a $ s t e
arbetskort	" " a r $ b e: t s $ % k U t`
jenom	j e $ " n o: m
pangkr	" " p a N $ % k r u: $ n U r
kopparsil	" " k O $ p a $ s` I l
dat	" d a t
bevisteori	b e $ " " v i: s $ t e $ U $ % r i:
skitroligt	" " x\ i: t $ % r u: $ l I k t
tjug	" s' }: g
sixty	s I k $ " s t I
omnis	O m $ " n i: s
naäj	" n e e j
allsten	" " a l $ % s t e: n
faluböckerna	" " f A: $ l }: $ % b 9 $ k e $ n` a
paleys	p a $ l I s
gullfisken	" " g u0 l $ % f I $ s k e n
vasegod	v a $ s e $ " g u: d
parkarbete	" " p a r k $ a r $ % b e: $ t e
bfakontoret	b e: $ f a $ k O n $ % t u: $ r e t
startsen	" " s t A: t` $ s` e n
gräddhämtare	" " g r e d $ % h e m $ t a $ r e
slugt	" s l }: g t
nittosex	" " n I $ t O $ " s e k s
nitt	" " n I t
tjugiett	" " s' }: $ g I $ " e t
storskaligt	" " s t u: $ % s` k A: $ l I k t
modekarusellen	" " m u: $ d e $ k a $ r }: $ % s e $ l e n
reglerad	r e $ " g l e: $ r a d
salladsfat	" " s a $ l a t s $ % f A: t
datalingvistlinjen	" " d A: $ t a $ l I N $ % v I s t $ % l i: $ n j e n
stensturegatan	" " s t e: n $ s t }: $ r e $ % g A: $ t a n
skitmycke	" " x\ i: t $ % m Y $ k e
kommigungan	k O $ m I $ " g u0 N $ a n
hundrasextiotusen	" " h u0 n $ d r a $ " " s e k $ s t I $ U $ " t }: $ s e n
sexhundratusen	s e k s $ h u0 n $ d r a $ % t }: $ s e n
handtagena	" " h a n d $ % t A: $ s` e $ n a
play	p l e j
uthyrningsverksamhet	" " }: t $ h y: $ n` I N s $ v e r k $ s a m $ % h e: t
skitgott	" " x\ i: t $ % g O t
bildstimuli	" " b I l d $ s t I $ m }: $ l I
satslogik	" " s a t s $ l U $ % g i: k
klargörande	" " k l A: r $ % j 2: $ r a n $ d e
straffad	" " s t r a $ f a d
sextionie	" " s e k $ s t I $ U $ " " n i: $ e
svetset	" s v e t $ s e t
ili	" " i: $ l I
dammsugarmunstycket	" " d a m $ % s }: $ g a r $ m u0 n $ % s t Y $ k e t
oljekraftverk	" " O l $ j e $ k r a f t $ % v e r k
smoke	" " s m o: $ k e
oli	" " u: $ l i:
blästres	" " b l e $ s t r e s
mötesprotokoll	" " m 2: $ t e s $ p r U $ t U $ % k O l
löfs	" l 2: v s
orginal	O r $ g I $ " n A: l
mtt	e m $ t e: $ " t e:
önte	2: n $ t e
telexempel	" t e: $ l e k $ % s e m $ p e l
konfliktlösningsmodeller	k O n $ " " f l I k t $ % l 2: $ s n I N s $ m U $ % d e $ l e r
yyy	" " y: y:
hattgruppens	" " h a t $ % g r u0 $ p e n s
reter	" " r e: $ t e r
inbjudna	" " I n $ % b j }: d $ n a
cxe	s e k $ s e
treti	" " t r e: $ t I
jättelessen	" " j e $ t e $ l e $ s e n
varsitt	" " v A: $ % s` I t
saturday	s a $ " " t u0 $ d` e j
tuppbok	" " t u0 p $ % b u: k
killfjuttarna	" " k I l $ f j u0 $ t a $ n` a
hämtad	" " h e m $ t a d
jha	" " j i: $ % h A:
tängt	" t e N t
passer	p a $ " " s e: r
havent	" h A: $ v e n t
bordlagt	" " b u: d` $ % l` a k t
noe	" n u:
plockad	" " p l O $ k a d
saru	s a r $ " }:
suss	" " s u0 s
världsgaranti	" " v E: d` s` $ g a $ r a n $ % t i:
nowhere	" n o: $ v E: r
intrasubjektiv	" " I n $ % t r A: $ s u0 $ b j e k $ t i: v
twenty	" t v a n $ t Y
bearbetad	" " b e: $ a r $ % b e: $ t a d
studierum	" " s t }: $ d I $ e $ % r u0 m
åryds	" " o: $ r y: d s
rc	e r $ s e n t
born	" " b o: n`
eftesom	" " e f $ t e $ s O m
jättegrej	" " j e $ t e $ g r e j
ones	" U $ a n s
lenni	" l e $ n I
energitunga	e $ n e r $ " " x\ i: $ % t u0 N $ a
fortran	f O $ " " t` r a n
huvu	" " h }: $ v u0
grammefon	" g r a $ m e $ f O n
ettusenniehundra	e t $ " t }: $ s e $ n I $ " h u0 n $ d r a
hrm	" h e r m
krigena	k r I $ " g e: $ n a
days	" d e j s
nittonhundraåtti	" " n I $ t O n $ h u0 n $ d r a $ O $ t I
flyttes	" f l Y $ t e s
lyxit	" " l Y k $ s I t
meet	m e $ e t
kundämnen	" " k u0 n d $ % e m $ n e n
löset	" " l 2: $ s e t
sea	" " s e: $ a
abbelyckan	a $ b e $ % l Y $ k a n
efte	" " e f $ t e
rengöringsband	" " r e: $ n j 2: $ r I N s $ % b a n d
teveshop	" " t e: $ v e: $ % x\ O p
forsk	f O s` k
paid	" p e j d
tuschtavla	" " t u0 s` $ % t` A: v $ l a
imot	I $ " " m O t
faster	" " f a $ s t e r
uppfylld	" " u0 p $ % f Y l d
audiologen	a*U $ d I $ U $ " l o: $ g e n
fyrafemtio	" " f y: $ r a $ f e m $ t I $ U
tykas	" " t y: $ k a s
vartannat	" " v A: $ % t` a $ n a t
tksch	t k s`
chicky	" " s' I $ k Y
tvärsen	" " t v e $ s` e n
stadsdelschefer	" " s t a t s $ d e: l s $ % x\ e: $ f e r
springe	" " s p r I N $ e
veto	" v e: $ t U
kemiutsläppen	s' e $ " " m i: $ }: t $ % s l e $ p e n
etthundratjufem	e t $ h u0 n $ d r a $ s' }: $ " f e m
vidpunkto	" " v i: d $ p u0 N k $ t U
smälla	" " s m e $ l a
cubase	k u0 $ " b A: $ s e
bibba	" " b I $ b a
pontac	p O n $ " t a k
intäktskrav	" " I n $ t e k t s $ % k r A: v
wa	" v a
elvia	" " e l $ v I $ a
karim	" " k A: $ % r I m
nietiden	" " n i: $ % t i: $ d e n
träningsoverall	" " t r E: $ n I N s $ o: $ v e $ % r o: l
linnéstaden	l I $ " " n e: $ % s t A: $ d e n
mumin	" " m }: $ m I n
hursomhelst	" h U $ s` O m $ " h e l s t
skratte	" s k r a $ t e
koppaspannen	" " k O $ p a $ % s p a $ n e n
verkstadsjobb	" " v e r k $ s t A: d s $ % j O b
presser	" p r e $ s e r
ou	" " u:
verkisto	" " v e r k $ I $ s t O
didakt	d I $ " d a k t
gruver	" " g r }: $ v e r
nittonhundranittiofyra	" " n I $ t O n $ h u0 n $ d r a $ n I $ t I $ U $ " " f y: $ r a
wo	" v O
gonna	" g O $ n a
vänna	" " v e $ n a
föt	" f 2: t
behagel	b e $ " h A: $ g e l
uppköping	" " u0 p $ % s' 2: $ p I N
mass	" " m a s
knuffad	" " k n u0 $ f a d
videoapparat	" " v i: $ d e $ U $ a $ p a $ % r A: t
kråker	" " k r o: $ k e r
thanks	" t a N k s
schaktningslov	" " x\ a k t $ n I N s $ % l o: v
medd	m e d
nittonhundrasextiofem	" " n I $ t O n $ h u0 n $ d r a $ s e k $ s t I $ U $ " f e m
adjö	a $ " j 9
undeligt	" " u0 n $ d e $ l I k t
potatisplättar	p U $ " " t A: $ t I s $ % p l e $ t a r
utlärning	" " }: t $ % l E: $ n` I N
bidjarmattan	" b I d $ " j A: r $ % m a $ t a n
prinsesser	p r I n $ " " s e $ s e r
date	" " d A: $ t e
ettusenetthundra	e t $ " t }: $ s e n $ " " e t $ " h u0 n $ d r a
svarve	" " s v a r $ v e
kundordrar	" " k u0 n d $ % o: $ d` r a r
resultaträkning	r e $ s u0 l $ " " t A: t $ % r E: $ k n I N
ope	O $ p e
tvåtusenniehundra	" " t v o: $ t u0 $ s e $ n I $ " h u0 n $ d r a
spindelbil	" " s p I n $ d e l $ % b i: l
kopparspann	" " k O $ p a $ s` p a n
bremenhult	" b r e: $ m e n $ % h u0 l t
unjefär	u0 $ n j e $ f E: r
bönnera	" " b 2: n $ % n e: $ r a
sciences	" s a $ j e n s
moretti	m U $ " " r e $ t I
tc	" " t e: $ % s e:
tss	" t s
åsch	O s`
hundranittisju	" " h u0 n $ d r a $ n I $ t I $ " x\ }:
öppifrån	9 $ p I $ % f r o: n
zodiakidoj	s U $ d I $ " A: $ k I $ d O j
kune	" k }: $ n e
ettusenfem	e t $ " t }: $ s e n $ " f e m
stö	" s t 2:
utmä	" " }: t $ m E:
proce	p r U $ " " s e
försvararn	f 9 $ " s` v A: $ r a n`
explorativa	e k $ s p l U $ r a $ t i: $ v a
kopparbytta	" " k O $ p a r $ % b Y $ t a
byxerna	" " b Y k $ s e $ n` a
roberts	" r o: $ b e t` s`
laughing	" l A: f I N
message	m e $ " " s A: s`
ick	i: $ s e: $ " k o:
cdn	s e: $ d e: $ " e n
storstadskultur	" " s t u: $ s` t` A: d s $ k u0 l $ % t }: r
husena	" " h }: $ s e $ n a
flyttext	" " f l y: t $ % t e k s t
14.0	" e t f y: $ r a $ r e n
nollåtta	" " n O l $ " " O $ t a
labak	" l A: $ b a k
oljenotan	" " O l $ j e $ % n u: $ t a n
samplat	" " s a m $ p l a t
barnbidragsanvisningen	" " b A: n` $ b i: $ d r A: g s $ a n $ % v i: $ s n I N $ e n
försö	f 9 $ " s` 2:
pålysningar	" " p o: $ % l y: $ s n I N $ a r
omöjli	" " u: $ % m 9 j $ l I
råvarerna	" " r o: $ v A: $ r e $ n` a
sva	" s v a
cookie	" k U k I
åsse	O $ s e
styrtext	" " s t y: $ % t` e k s t
snabelgren	" " s n A: $ b e l $ g r e: n
sjuer	" " x\ }: $ e r
märklit	" " m e r $ k l I t
anslutna	" " a n $ % s l }: t $ n a
skan	" " s k a n
find	" f I n d
nittisex	" n I $ t I $ " s e k s
abso	a p $ s U
oregistrerbart	" " u: $ r e: $ j I $ " s t r e: r $ b A: t`
bnjafniä	b e: $ n j a $ f n I E
nöe	" " n 2: $ e
ekasjön	" " e: $ k a $ % x\ 9 n
strukturerat	s t r u0 k $ t }: $ % r e: $ r a t
schackprogram	" " x\ a k $ p r U $ % g r a m
ickeverbal	" " I $ k e $ v e r $ " b A: l
tillbak	t I l $ " b A: k
cartney	" k A: t` $ n` I
kålltorp	" " k O l $ t O r p
halvdant	" " h a l v $ d A: n t
återbetalningsvillkor	" " o: $ t e r $ b e $ % t A: l $ n I N s $ v I l $ % k o: r
ägandeformerna	$ E: $ g a n $ d e $ % f O r $ m e $ n` a
sörru	s 9 $ r u0
öhö	" " 2: $ h 2:
hornklausullogik	" " h u: n` $ k l a*U $ % s }: l $ l U $ % g i: k
lig	" " l I g
överraskad	" " 2: $ v e $ % r a s $ k a d
krigsföring	" " k r I k s $ % f 2: $ r I N
förstörda	f 9 $ " s` t` 2: $ d` a
djingis	d j I N $ I s
familjebostadsbidrag	f a $ " " m I l $ j e $ b u: $ s t A: d s $ b i: $ % d r A: g
lågtrafiklinjerna	" " l o: g $ t r a $ f i: k $ % l i: $ n j e $ n` a
gd	g d
stadsbiblotek	" " s t a t s $ b I $ b l U $ " t e: k
middjan	" m I d $ j a n
maskindivisionen	m a $ " " x\ i: n $ % d I $ v I $ % x\ u: $ n e n
tannläkarn	t a n $ l E: $ k a n`
högtalarn	" " h 2: g $ t A: $ l a n`
pam	" " p a m
dekl	d e $ k l }: $ " s i: $ v e
gammaldags	" " g a $ m a l $ % d a k s
sextiåtta	" " s e k $ s t I $ " " O $ t a
nääej	" n E: e j
iförsej	" " i: $ % f 2: $ s` e j
chilinötter	" " s' i: $ l I $ % n 9 $ t e r
nejmen	" n e j $ m e n
click	" k l I k
kuvertväskan	k }: $ " " v E: r $ % v e $ s k a n
jättekonstigt	" " j e $ t e $ % k O n $ s t I k t
staying	" s t e $ j I N
buffe	" b u0 $ f e
jah	" " j a
kundföretagen	" " k u0 n d $ f 2: $ r e $ % t A: $ g e n
skitfräckt	" " x\ i: t $ % f r e k t
trendsetter	" " t r e n d $ % s e $ t e r
ungdomliga	" " u0 N $ % d U m $ l I $ g a
sirocko	s I $ " r O $ k U
evening	e $ v e $ n I N
provtvättat	" " p r u: v $ % t v e $ t a t
skaj	" s k a j
hundrasextiofyra	" " h u0 n $ d r a $ " " s e k $ s t I $ U $ " " f y: $ r a
vikka	" v I $ k a
when	" v e n
wat	" v A: t
kampingstolar	" k a m $ p I N $ % s t u: $ l a r
offentligt	U $ " " f e n t $ l I k t
träffer	" t r e $ f e r
ingefärsurna	" " I N $ e $ f E: s` $ % }: $ n` a
problemas	p r U $ b l e $ m a s
hemlisar	" " h e m $ % l i: $ s a r
kalkat	" " k a l $ k a t
pope	" p o: $ p e
across	a $ " k r O s
fyrstjärnit	" " f y: r $ % x\ E: $ n` I t
flytter	" f l Y $ t e r
fjortonhundra	" " f j u: $ t` O n $ h u0 n $ d r a
kanska	" k A: n $ s k a
områdeskontoret	" " O m $ r o: $ d e s $ k O n $ % t u: $ r e t
skördetrösker	" " x\ 2: $ d` e $ % t r 9 $ s k e r
synes	" " s y: $ n e s
hmh	" h u0 m
balustrik	b a $ " l u0 $ s t r I k
half	" h a l f
troser	" " t r u: $ s e r
ettusentvåhundra	e t $ " t }: $ s e n $ % t v o: $ " h u0 n $ d r a
naturgrejer	n a $ " " t }: r $ % g r e $ j e r
glasbord	" " g l A: s $ % b u: d`
reservcheckar	r e $ " " s e r v $ % s' e $ k a r
måss	" " m O s
matsarne	" " m A: t $ s A: $ n` e
hotellnatt	h U $ " " t e l $ % n a t
trettiofyran	" " t r e $ t I $ U $ " " f y: $ r a n
överlevande	" " 2: $ v e $ % l` e: $ v a n $ d e
tvådelat	" " t v o: $ % d e: $ l a t
neotech	n e: $ U $ " t e k
göteborgsposten	j 2: $ t e $ " " b O r j s $ % p O $ s t e n
möe	" " m 2: $ e
berörd	b e $ " r 2: d`
nitromex	n I $ t r U $ m e k s
skolena	" " s k u: l $ e $ n a
lungt	" " l u0 N t
affärstidslagen	a $ " " f E: s` $ % t` i: d s $ % l A: $ g e n
entwicklung	a N $ " " t v I $ k l u0 N
kommunikationssätten	k O $ m }: $ n I $ k a $ " " x\ u: n s $ % s e $ t e n
ungef	u0 $ n j e $ " f
niotusen	" " n i: $ U $ " t }: $ s e n
analiza	a $ n a $ " l i: $ s a
allright	a l $ " r a j t
hänvisad	" " h E: n $ % v i: $ s a d
icakuriren	" " i: $ k a $ k }: $ " r i: $ r e n
ialla	I $ " " a $ l a
öppnarn	% 9 p $ n a n`
måles	" m o: $ l e s
allwood	a l $ " v U d
bindefelt	" " b I n $ d e $ % f e l t
exfog	" " e k s $ % f u: g
surtesjön	" " s u0 $ t` e $ % x\ 9 n
hascha	" " h a $ s` a
mbp	e m $ b e: $ " p e:
xtvå	k s $ % t v o:
fempoängare	" " f e m $ p U $ % e N $ a $ r e
uu	" u:
hundrasjuttinie	" " h u0 n $ d r a $ " " x\ u0 $ t I $ n I
cykelskylten	" " s Y $ k e l $ % x\ Y l $ t e n
prismässigt	" " p r i: s $ % m e $ s I k t
seventyfive	" s e $ v e n $ t y: $ f i: $ v e
tillkomme	" " t I l $ % k O $ m e
tjugetvå	" " s' }: $ g e $ " t v o:
infanoj	I n $ f a n $ " O j
pållare	" " p O $ l a $ r e
despero	d e $ s p e $ " r u:
vio	v I $ U
övria	" " 2: v $ r I $ a
hawk	" h o: k
whiteboardpenna	" " v a j t $ b o: d` $ % p e $ n a
påverkbar	" " p o: $ v e r k $ % b A: r
åhh	U
krokodilgatan	k r U $ k U $ " " d i: l $ % g A: $ t a n
fuge	" " f }: $ g e
kryptonit	k r Y p $ t U $ " n i: t
fritidsstugorna	" " f r i: $ t i: d s $ % s t }: $ g U $ n` a
silvergärde	" " s I l $ v e r $ % j E: $ d` e
begreppsförklaring	b e $ " " g r e p s $ f 9 r $ % k l A: $ r I N
weve	" " v e: $ v e
vaför	v a $ " f 2: r
tråkit	" " t r o: $ k I t
barnbidragsanvisning	" " b A: n` $ b i: $ d r A: g s $ a n $ % v i: $ s n I N
sextiotusen	" " s e k $ s t I $ U $ " t }: $ s e n
ottesten	" " U $ t e $ % s t e: n
ec	" " e: $ % s e:
laws	l o:
sexhundranittifem	s e k s $ h u0 n $ d r a $ n I $ t I $ " f e m
sakeset	" s e j k $ s e t
pensionerad	p a N $ x\ U $ " n e: $ r a d
ettusenåttahundra	e t $ " t }: $ s e n $ " " O $ t a $ " h u0 n $ d r a
ingiven	" " I n $ % j i: $ v e n
b-rummet	" " b e: $ % r u0 $ m e t
appropå	a $ p r O $ " p o:
bötespåföljd	" " b 2: $ t e s $ p o: $ % f 9 l j d
vengxo	" v E: N k $ s U
someone	" s O $ m e $ " o: $ n e
motståndarpartiet	" " m u: t $ s t O n $ d a r $ p a $ % t` i: $ e t
grundzuge	" " g r u0 n d $ s u0 $ g e
rollformulär	" " r O l $ f O r $ m }: $ % l E: r
fjä	" f j E:
cxu	s e n $ t I $ " k s u:
cause	" k o: s
file	" " f i: $ l e
uppskattad	" " u0 p $ % s k a $ t a d
made	m a $ d e
zürich	" s y: $ r I s'
trehundranittifem	t r e: $ h u0 n $ d r a $ n I $ t I $ " f e m
ettusentrehundra	e t $ " t }: $ s e n $ t r e: $ " h u0 n $ d r a
fårström	" " f o: $ % s` t` r 9 m
tschi	" t x\ I
privativ	p r I $ v a $ " t i: v
tvåtusenetthundra	" " t v o: $ t u0 $ s e $ n e t $ " h u0 n $ d r a
utsedd	" " }: t $ % s e d
dente	d e n $ t e
alright	" " A: l $ r a j t
oke	" u: $ k e
källarn	" " s' e $ l a n`
korvsockar	" " k O r v $ % s O $ k a r
fyraåenhalv	" " f y: $ r a $ o: $ e n $ h a l v
kristalln	k r I $ " " s t a l $ % n
fönstertvättare	" " f 9 n $ s t e $ % t` v e $ t a $ r e
plånboka	" " p l o: n $ % b u: $ k a
artefacts	a $ t` e $ " f a k t s
lädernålar	" " l E: $ d e $ % n` o: $ l a r
påverkbart	" " p o: $ v e r k $ % b A: t`
jättedumt	" " j e $ t e $ % d u0 m t
varuförteckning	" " v A: $ r }: $ f 9 $ % t` e $ k n I N
ige	I $ g e
nidbeskrivning	" " n i: d $ b e $ % s k r i: v $ n I N
ytterliggare	" " Y $ t e $ % l` I $ g a $ r e
dammsugarmunstycke	" " d a m $ % s }: $ g a r $ m u0 n $ % s t Y $ k e
svetslagning	" " s v e t s $ l A: $ g n I N
evis	e $ " v i: s
jus	" j U s
sjutusenfemhundra	x\ u0 $ " t }: $ s e n $ % f e m $ " h u0 n $ d r a
kamila	k a $ " " m I $ l a
basdrifter	" " b A: s $ % d r I f $ t e r
rooms	" r u: m s
europride	E*U $ r U $ p r i: $ d e
uppdaterat	" " u0 p $ d a $ % t e: $ r a t
personalsystem	p e $ s` U $ " " n A: l $ s Y $ % s t e: m
presskonferansen	" " p r e s $ k O n $ f e $ % r a n $ s e n
fastställd	" " f a s t $ % s t e l d
syke	s Y $ k e
uts	" u0 t s
förtingligat	f 9 $ " t` I N $ l I $ g a t
pä	" p E:
kopparkannan	" " k O $ p a r $ % k a $ n a n
subject	s u0 $ " " b j e k t
slipad	" " s l i: $ p a d
jor	" j u: r
tretusenfemhundratre	" " t r e: $ t }: $ s e n $ % f e m $ h u0 n $ d r a $ " t r e:
oåoaker	" " u: $ o: $ % u: $ k e r
miljöskyddande	m I l $ " " j 2: $ % x\ Y $ d a n $ d e
cxirkaux	k s I r $ k a*U
dreadlocks	" d r e d $ l O k s
representerad	r e $ p r e $ s e n $ " t e: $ r a d
kårn	" k o: n`
fare	f a $ r e
kummigungan	" " k u0 $ m I $ " g u0 N $ a n
whats	v e $ h O $ " A: t s
konkurrans	k O N $ " k u0 $ r a n s
skitsnyggt	" " x\ i: t $ % s n Y k t
kopparbyttan	" " k O $ p a r $ % b Y $ t a n
forment	f O r $ " m e n t
deco	d e $ k U
naturresuserna	n a $ " " t }: r $ r e $ s u0 $ s e $ n` a
aviation	a $ v I $ a $ " x\ u: n
learn	" l e: n`
mn	" e m $ e n
bandena	b a n $ d e $ n a
town	t a*U n
jämnlikhet	" " j e m n $ l i: k $ % h e: t
included	I N $ " k l u0 $ d e d
nääh	" n E:
vattne	" v a t $ n e
kombinerad	k O m $ b I $ " n e: $ r a d
helfullt	" " h e: l $ % f u0 l t
hönera	" " h 2: $ % n e: $ r a
förberedd	" " f 2: r $ b e $ % r e d
gali	g a $ " l i:
jättelänge	" " j e $ t e $ % l e N $ e
culture	" " k u0 l $ " " t }: $ r e
naeh	" n a j
underhållsstyrning	" " u0 n $ d e r $ h O l s $ % s t y: $ n` I N
says	" s e j s
resultatkravet	r e $ s u0 l $ " " t A: t $ % k r A: $ v e t
despera	d e $ s p e $ r a
texmex	t e k s $ m e k s
orga	O r $ g a
sjuttonhundra	" " x\ u0 $ t O n $ h u0 n $ d r a
tevara	" " t e: $ % v A: $ r a
provocerad	p r U $ v U $ " s e: $ r a d
ts	t s
help	" " h e: l $ % p e:
superbra	" " s }: $ p e r $ % b r A:
hap	" h a p
tolstoj	" t O l $ s t O j
cherpillod	x\ e r $ p I $ " l u: d
nittonhundrasextio	" " n I $ t O n $ h u0 n $ d r a $ s e k $ s t I $ U
affärsförhandlingar	a $ " " f E: s` $ f 9 r $ % h a n d $ l I N $ a r
septitanks	s e p $ " " t i: $ % t a N k s
allvali	" " a l $ v A: $ l I
hypercard	h Y $ p e r $ " k A: d`
machobicho	" " m a t $ s' U $ b I t s' O
tjaa	" s' a
tevefilmer	" " t e: $ v e $ % f I l $ m e r
parallelltext	p a $ r a $ " " l e l $ % t e k s t
ojojojoj	O j $ O j $ O j $ " O j
kvalitetspunkter	k v a $ l I $ " " t e: t s $ % p u0 N k $ t e r
lärarskicklighet	" " l E: $ r a r $ x\ I $ k l I g $ % h e: t
parkeringsplass	p a r $ " " k e: $ r I N s $ % p l a s
femtinie	f e m $ t I $ " " n i: $ e
råvaruresurser	" " r o: $ v A: $ r }: $ r e $ % s u0 $ s` e r
kickoffen	" " k I $ k O $ f e n
turmässan	t u0 r $ % m e $ s a n
adresserad	a $ d r e $ " s e: $ r a d
säk	" s E: k
utlandslånena	" " }: t $ l a n d s $ % l o: $ n e $ n a
tsempel	" " t s e m $ p e l
småbaggis	" " s m o: $ % b a $ g I s
tonight	t O N $ " a j t
beginning	b e $ " j I $ n I N
familjeomsorg	f a $ " " m I l $ j e $ O m $ % s O r j
redding	" " r e $ d I N
esperantolittratur	e $ s p e $ " " r a n $ t U $ l I $ t r a $ % t }: r
mellanvänd	" " m e $ l a n $ % v e n d
jonn	" j O n
hup	" h a p
lockurna	l O $ " " k }: $ n` a
lamperna	" " l a m $ p e $ n` a
obj	O $ " b j
stigläder	" " s t i: g $ % l E: $ d e r
sykurs	" " s y: $ % k u0 s`
diskmasjin	" " d I s k $ m a $ " s` i: n
oljeanvändning	" " O l $ j e $ a n $ % v e n d $ n I N
vogues	" v u: g s
hundrafyrtiofem	" " h u0 n $ d r a $ f 9 $ t` I $ U $ " f e m
sjunge	" " x\ u0 N $ e
plass	" " p l a s
producerad	p r U $ d }: $ " s e: $ r a d
snackhumör	" " s n a k $ h }: $ % m 2: r
harnte	h a r $ " n t
graviditetsstörningar	g r a $ v I $ d I $ " " t e: t s $ % s t 2: $ n` I N $ a r
förkl	f 9 r $ " k l
allergierna	a $ l e r $ " g i: $ e $ n` a
uppf	" " u0 p $ f
nogrann	" " n u: g $ % r a n
sjuhundratie	x\ }: $ h u0 n $ d r a $ " " t i: $ e
auxlang	a*U k $ s l a N
strömbro	" " s t r 9 m $ % b r u:
satelites	s a $ t e $ " " l i: $ t e s
kajsas	" " k a j $ s a s
bei	b e $ " i:
öveleva	" " 2: $ v e $ % l e: $ v a
hålgjort	" " h o: l $ % j U t`
skruver	" s k r }: $ v e r
marijuana	m a $ r I $ }: $ " " A: $ n a
böö	" b 2:
mölndalsgränsen	" " m 9 l n $ d A: l s $ % g r e n $ s e n
förfalskad	f 9 r $ " f a l $ s k a d
kalhygger	" " k A: l $ % h Y $ g e r
eldningsplatsen	" " e l d $ n I N s $ % p l a t $ s e n
rotere	" " r u: $ t e $ r e
göttaste	" " j 9 $ t a $ s t e
ambio	a m $ b I $ U
åte	" " o: $ t e
exprimentets	e k $ s p r I $ " m e n $ t e t s
atari	a $ t a $ r I
utbilningen	" " }: t $ b I l $ n I N $ e n
pao	p a*U
lanchi	" l a N $ k I
nittonhundrasjuttio	" " n I $ t O n $ h u0 n $ d r a $ " x\ u0 $ t I $ U
bedrägerit	b e $ d r E: $ g e $ " " r i: t
hannstil	" h a n $ % s t i: l
sextifem	" " s e k $ s t I $ " f e m
responsorden	r e $ s p O n $ " " s u: $ d` e n
akvarium	a $ " " k v A: $ r I $ u0 m
helsicke	" " h e l $ s I $ k e
häliga	" h e $ l I $ g a
sletna	" s l e: t $ n a
himself	" " h I m $ % s e l v
salmböckerna	" s a l m $ % b 9 $ k e $ n` a
busy	" " b }: $ s Y
teroj	" t e: $ r O j
bentsson	" b e n t $ s O n
föklaring	f 9 $ " " k l A: $ r I N
sjöhem	" " x\ 2: $ % h e m
trehundratrettisex	t r e: $ h u0 n $ d r a $ t r e $ t I $ % s e k s
mäng	" m e N
växjöblocket	" " v e k $ x\ 2: $ % b l O $ k e t
urbansson	u0 r $ " b A: n $ s O n
familjeparkering	f a $ " " m I l $ j e $ p a r $ % k e: $ r I N
hempermanent	" h e m $ p e r $ m a $ " n e n t
nisenska	n I $ " s e n $ s k a
polhemsgården	" " p u: l $ h e m s $ % g o: $ d` e n
svängstad	" " s v e N $ % s t A: d
plö	" " p l 2:
konstmuséer	" " k O n s t $ m }: $ " s e: $ e r
bertåke	b e t` $ " " o: $ k e
death	" d i: $ t
fub	" f u0 b
stockholmsgård	" " s t O k $ h O l m s $ % g o: d`
sjutiåtta	" " x\ }: $ t I $ " " O $ t a
kulturstaden	k u0 l $ " " t }: $ % s` t` A: $ d e n
vock	" v O k
kancelera	k a n $ " s e: $ l e $ r a
röntgat	" " r 9 n t $ k a t
34.0	" t r e: $ % f y: $ r a $ r e n
fackgranskning	" " f a k $ % g r a n s $ k n I N
15.0	" e t u0 $ t e $ r e n
torktumla	" " t O r k $ % t u0 m $ l a
astersson	" " a $ s t e $ s` O n
spårinnehavare	" " s p o: r $ I $ n e $ % h A: $ v a $ r e
gansk	" g A: n s k
etthundrafyrtisex	e t $ h u0 n $ d r a $ f 9 $ t I $ " s e k s
kolalternativ	" " k o: l $ a l $ t e $ n` a $ % t i: v
ingtin	" " I N $ t i: n
säljen	" " s e l $ j e n
konfliktlösningsprocess	k O n $ " " f l I k t $ % l 2: $ s n I N s $ p r U $ % s e s
undr	}: $ e n $ " " d e: $ % e r
informerer	I n $ f O r $ " m e: $ r e r
wohoho	" v O O $ h O
rengjort	" " r e: n $ % j U t`
dette	" d e t
ning	" n I N
kangaroo	" k a N $ g a $ " r u:
unnvika	" u0 n $ % v i: $ k a
huvuämne	" " h }: $ v u0 $ % e m $ n e
cabbarny	" " k a $ b a $ n` Y
förlängda	f 9 $ " l` e N $ d a
tisdagkväll	" " t i: s $ d A: g $ % k v e l
nittonhundrasjuttiotvå	" " n I $ t O n $ h u0 n $ d r a $ x\ u0 $ t I $ U $ " t v o:
konferansrummet	k O n $ f e $ " " r a n s $ % r u0 $ m e t
utsträckn	" " }: t $ % s t r e $ k n
förtitre	f 9 $ " t` i: $ t r e
youll	" j o: l
noveloj	n U $ " v e $ l O j
frånn	" " f r o: n $ % e n
tisdakväll	" t i: s $ d a $ % k v e l
low	" l O v
görschvårt	j 9 r $ " s` v o: t`
kungsladugård	k u0 N s $ " " l A: $ d }: $ % g o: d`
maupain	m a*U $ p e j n
bottensträngen	" " b O $ t e n $ % s t r e N $ e n
krige	k r I $ g e
nånannanstans	" n O n a $ n a n $ % s t a n s
överrumplad	" " 2: $ v e $ r u0 m $ p l a d
snabbavveckla	" " s n a b $ A: $ % v e $ k l a
wieselgrensplatsen	" " v i: $ s e l $ g r e: n s $ % p l a t $ s e n
stekelverket	" " s t e: $ k e l $ % v e r $ k e t
kir	" k i: r
him	" h I m
enminutarna	" " e: n $ m I $ n }: $ t a $ n` a
dragskydd	" " d r A: g $ % x\ Y d
kulturvariation	k u0 l $ " " t }: r $ v a $ r I $ a $ % x\ u: n
gärningsbeskrivningen	" " j E: $ n` I N s $ b e $ % s k r i: v $ n I N $ e n
åsikte	" " o: $ % s I k $ t e
batteriladdare	b a $ t e $ " " r i: $ % l a $ d a $ r e
mattiass	m a $ " " t i: $ a s
mtab	e m $ t a b
bageriområdet	b A: $ g e $ " " r i: $ O m $ % r o: $ d e t
papperskopier	" " p a $ p e s` $ k U $ % p i: $ e r
oppkäftigt	" " O p $ % s' e f $ t I k t
enkroner	" " e: N $ k r u: $ n e r
plastbågarna	" " p l a s t $ % b o: $ g a $ n` a
acquisition	a k $ " k i: $ s I $ " x\ u: n
gära	" " j E: $ r a
verke	" v e r $ k e
generalsbranschen	j e $ n e $ " " r A: l s $ % b r a n` $ s` e n
hantaget	h a n $ " t A: $ s` e t
köksvägg	" " s' 9 k s $ % v e g
ljudstimuli	" " j }: d $ s t I $ m }: $ l I
micket	" " m I $ k e t
grottstadiet	" " g r O t $ s t A: $ d I $ e t
doing	d U $ I N
storarummet	" " s t u: $ r a $ % r u0 $ m e t
himalajas	h I $ " m A: $ l a $ j a s
tibi	t I $ " b i:
fälld	" f e l d
bvitamin	b e $ v I $ t a $ % m i: n
njea	" n j e: $ a
översätt	$ 2: $ v e $ % s` e t
kosbanden	" " k u: s $ % b a n $ d e n
hundratjugoåtta	" " h u0 n $ d r a $ s' }: $ g U $ " " O $ t a
remitterat	r e $ m I $ " t e: $ r a t
åff	O f
bonne	" b O n
modelle	m U $ " d e $ l e
wasteland	" " v a $ s t e $ % l a n d
folkomröstningsdebatten	" " f O l k $ O m $ r 9 s t $ n I N s $ d e $ % b a $ t e n
kumigångan	" k }: $ m I $ " g O N $ a n
namen	n a $ m e n
världshavena	" " v E: d` s` $ % h A: $ v e $ n a
kärnkraftsdebatten	" " s' E: n` $ k r a f t s $ d e $ % b a $ t e n
villby	" " v I l $ b y:
tvåfemtio	" " t v o: $ f e m $ t I $ U
oehört	" " u: $ e $ % h 2: t`
jungfruknoppar	" " j u0 N $ f r }: $ % k n O $ p a r
stude	s t }: $ d e
vao	v a $ " u:
responsord	r e $ s p O n $ " " s u: d`
reagerer	r e $ a $ " g e: $ r e r
feedbackframkallande	" f i: d $ b e k $ f r a m $ % k a $ l a n d $ d e
hundraåttiosexan	" " h u0 n $ d r a $ O $ t I $ U $ " s e k $ s a n
kvalitetsstyrningssystem	k v a $ l I $ " " t e: t s $ % s t y: $ n` I N s $ s Y $ % s t e: m
mekaniserbart	m e $ k a $ n I $ " s e: r $ b A: t`
näedå	" " n E: $ e $ d O
quickest	" k v I k e s t
josminka	" j O $ s m I N $ k a
formaggio	" " f O r $ m a d $ j U
always	" " a l $ v e j s
skuri	" " s k }: $ r I
sinclaire	s I N $ " k l E: r
järnvägsinspektion	" " j E: n` $ v E: g s $ I n $ s p e k $ % x\ u: n
pl	" " p e: $ % e l
bärgningsskedet	" " b e r j $ n I N s $ % x\ e: $ d e t
infödingstammar	" " I n $ % f 2: $ d I N $ % s t a $ m a r
värderinger	v e $ " d` e: $ r I N $ e r
biografnamn	b i: $ U $ " " g r A: f $ % n a m n
programmeringsmetodiken	p r U $ g r a $ " " m e: $ r I N s $ m e $ t U $ % d i: $ k e n
4.5	" " f y: $ r a $ r u0
bevishänseende	b e $ " " v i: s $ h E: n $ % s e: $ e n $ d e
vok	" v O k
sterjo	" s t E: r $ j U
jättegla	" " j e $ t e $ % g l a
kontexte	k O n $ " t e k $ s t e
neubergska	n e: $ }: $ " b E: r j $ s k a
alkolister	" " a l $ k U $ % l I $ s t e r
herrglasögon	" " h e r $ g l A: s $ % 2: $ g O n
trelånga	" " t r e: $ % l O N $ a
greppat	" " g r e $ p a t
kommunalingenjören	k O $ m }: $ " " n A: l $ I N $ x\ e n $ % j 2: $ r e n
vasågo	v A: $ s o: $ g U
background	" " b a k $ g r a*U n d
stilfigurer	" " s t i: l $ f I $ % g }: $ r e r
höje	" " h 9 $ j e
idiotisch	I $ d I $ U $ " t I s`
ordförrådsinlärning	" " u: d` $ f 9 $ % r o: d s $ I n $ % l E: $ n` I N
mässområdet	" " m e s $ O m $ % r o: $ d e t
terrawattimmar	t e $ r a $ " " v a t $ % t I $ m a r
hundrafjorton	" " h u0 n $ d r a $ " " f j U $ t` O n
femhundratusen	f e m $ h u0 n $ d r a $ % t }: $ s e n
euroagenturer	" " e $ v r U $ a $ g e n $ % t }: $ r e r
karnavale	" " k A: $ n` a $ " v A: $ l e
naturli	n a $ " " t }: r $ % l` i:
mördad	" " m 2: $ d` a d
lokalförslaget	l U $ " " k A: l $ f 9 $ % s` l` A: $ g e t
vitagit	" " v i: $ % t A: $ g I t
jö	" " j 2:
eugeniahemmet	E*U $ " x\ e: $ n I $ a $ % h e $ m e t
byxer	" " b Y k $ s e r
tvåtusennittifem	" " t v o: $ t u0 $ s e $ n I $ t I $ " f e m
thinks	" " t I N k s
fjärran	" " f j e $ r a n
fav	" " e f $ A: v
grundtaxa	" " g r u0 n d $ % t a k $ s a
hjulena	" j }: $ l e $ n a
erar	" " e: $ r a r
gaus	" g a*U
wau	" v o:
egentl	e $ " j e n $ t e l
santanas	s a n $ " t A: $ n a s
enga	a N $ g a
termobyxer	t e r $ m U $ % b Y k $ s e r
stabena	s t a $ " b e: $ n a
validetet	v a $ l I $ " d e: $ t e t
ungdomsbiljetten	" " u0 N $ d U m s $ b I l $ % j e $ t e n
befolknigen	b e $ " " f O l $ k n I $ g e n
capo	" k A: $ p U
kopulakom	k U $ p u0 $ l a $ " k o: m
häradsson	" " h E: $ r a t $ s O n
skrivi	" " s k r i: v $ % i:
mediterat	m e $ d I $ " t e: $ r a t
ig	" " I g
språ	" s p r o:
house	" j u: $ s e
tjötar	" s' 2: $ t a r
direktkonsult	d I $ " " r e k t $ k O n $ % s u0 l t
klumpit	" " k l u0 m $ p I t
espaniol	e $ s p a $ n I $ % u: l
mossebergsskolans	" " m O $ s e $ b e r j s $ % s k u: $ l a n s
fourth	" f u: t`
masti	" " m a $ s t I
lapenna	" " l A: $ p e $ n a
hamadanmattan	h a $ " m a $ a n $ % m a $ t a n
frotte	f r U $ " t e:
nånstan	" n O n $ s t a n
femt	" " f e m t
shipping	" s` I $ p I N
artu	a $ " t` u:
sanctorum	" s a n $ t t` u: $ r u0 m
uk	" " }: $ k o:
bihålsinflammation	" " b i: $ h o: l s $ I n $ f l a $ m a $ % x\ u: n
junte	" " j u0 n $ t e
kyndelsson	" " s' Y n $ d e l $ s O n
dryftat	" " d r Y f $ t a t
pundo	" " p u0 n $ d U
forskarsituationen	" " f O $ s` k a $ s` I $ t }: $ a $ % x\ u: $ n e n
nitche	" " n i: t $ s`
jordgubb	" " j u: d` $ g u0 b
bordla	" " b u: d` $ l` a
ovanfö	" " o: $ v a n $ f 2:
mvl	" e m $ v e: $ " e l
kostnadsställen	" " k O s t $ n a t s $ % s t e $ l e n
lågprisaffär	" " l o: g $ p r i: s $ a $ % f E: r
babe	" b A: $ b e
skitsvårt	" " x\ i: t $ % s v o: t`
hypotetist	h Y $ p U $ t e $ " t I s t
berätte	b e $ " r e $ t e
äte	" E: $ t e
soc	" s O k
seru	" s e: $ r u0
ytfinishen	" " y: t $ f I $ n I $ s` e n
maktutspridning	" " m a k t $ }: t $ % s p r i: d $ n I N
trö	" t r 2:
motståndarn	" " m u: t $ s t O n $ d a n`
dyke	" d y: $ k e
disskutera	d I $ s }: $ % t e: $ r a
would	" v U l d
videocirklar	" " v i: $ d e $ U $ % s I r $ k l a r
övernattningstaxa	" " 2: $ v e $ % n` a t $ n I N s $ % t a k $ s a
personblad	p e $ " " s` u: n $ % b l A: d
kockkniven	" " k O k $ % k n i: $ v e n
fys	" f y: s
wine	" v I n
lyssner	" " l Y $ s n e r
tjöpt	" s' 2: p t
bakhuvet	" " b A: k $ % h }: $ v e t
forty	f O $ " " t` Y
antestorp	" " a n $ t e s $ % t O r p
iski	I $ s k I
neobonde	" " n e: $ U $ % b U n $ d e
slutdörr	" " s l }: t $ % d 9 r
poj	" " p O j
konferansanläggningen	k O n $ f e $ " " r a n s $ a n $ % l e $ g n I N $ e n
tarjan	" " t a r $ j a n
elektitaj	e $ " " l e k $ t I $ " t a j
meddelandesystem	" " m e: $ % d e: $ l a n d $ d e $ s Y $ % s t e: m
tågset	" " t o: g $ s e t
vikket	" v I $ k e t
symbolfunktion	s Y m $ " " b o: l $ f u0 N k $ % x\ u: n
tomtebringare	" " t O m $ t e $ % b r I N $ a $ r e
spritfester	" " s p r i: t $ % f e $ s t e r
gudomlihet	g u0 $ " d U m $ l I $ h e: t
expansionsmedel	e k $ s p a N $ " " x\ u: n s $ % m e: $ d e l
agressiv	a $ g r e $ " s i: v
thailänska	" " t a j $ % l e n $ s k a
sårad	" " s o: $ r a d
kano	" " k A: $ n U
nittåtta	" " n I t $ " " O $ t a
jättedålit	" " j e $ t e $ % d o: $ l I t
ops	" " u: p s
tvååri	" " t v o: $ % o: $ r I
kundämnena	" " k u0 n d $ % e m $ n e $ n a
projektsekreterare	p r U $ " " x\ e k t $ s e $ k r e $ " " t e: $ r a $ r e
säa	" " s E: $ a
vidvinkel	" " v i: d $ v I N $ k e l
campat	" " k a m $ p a t
teeshirts	" t e: $ $ s` 2: t` s`
sale	" " s A: $ l e
svedaj	s v e $ " d a j
bordlagd	" " b u: d` $ % l` a g d
preci	p r e $ " s i:
daghemsavdelning	" " d A: g $ h e m s $ A: v $ % d e: l $ n I N
exempl	e k $ s e m $ " p l
high	" h i: g
hannknutna	" " h a N $ % k n }: t $ n a
kontraktsgenomgång	k O n $ " " t r a k t s $ j e: $ n O m $ % g O N
vouchers	" " v U $ s` e s`
datormässighet	" " d A: $ t U r $ m e $ s I g $ % h e: t
sågod	s o: $ " g u: d
bahasan	b a $ " h A: $ s a n
åck	O k
rapportgenerator	r a $ " " p O t` $ % j e $ n e $ % r A: $ t U r
tretusensjuhundra	" " t r e: $ t }: $ s e n $ x\ }: $ " h u0 n $ d r a
telephonecall	t e $ l e $ " f O $ n e k o: l
sändlista	" " s e n d $ % l I $ s t a
brännerlund	" " b r e $ n e $ % l` u0 n d
återföräljare	" " o: $ t e r $ f 9 r $ % e l $ j a $ r e
su	" s }:
olskrokens	" " U l s $ k r u: $ k e n s
tjugetredje	" " s' }: $ g e $ " " t r e: d $ j e
häft	" " h e f t
tecno	" " t e $ k n U
uppföljningsprojektet	" " u0 p $ f 9 l j $ n I N s $ p r U $ % x\ e k $ t e t
atso	a t $ s O
sängknoppar	" " s e N $ % k n O $ p a r
kontro	k O n $ " t r u:
arholm	" " A: r $ % h O l m
onatur	" " u: $ n a $ % t }: r
uppklassningsrör	" " u0 p $ % k l a $ s n I N s $ % r 2: r
verklien	" " v e r $ k l I $ e n
konferanser	k O n $ f e $ " r a n $ s e r
jante	" " j a n $ t e
naturuppfattning	n a $ " " t }: r $ u0 p $ % f a t $ n I N
väststaterna	" " v e s t $ % s t A: $ t e $ n` a
basstrukturen	" " b A: s $ s t r u0 k $ % t }: $ r e n
fakti	" f a k $ t I
presupponerar	" " p r e s }: $ p U $ " n e: $ r a r
femstjärnit	" " f e m $ % x\ E: $ n` I t
skulla	" " s k u0 $ l a
nights	" n i: g t s
dåså	" " d o: $ s O
grävskoper	" " g r E: v $ % s k u: $ p e r
förutsatte	" " f 2: r $ }: t $ % s a $ t e
kiitos	" k i: $ t O s
bee	" b i:
hjulbalansen	" " j }: l $ b a $ % l a n $ s e n
nedanfö	" " n e: $ d a n $ f 2:
bästaslakteriet	" " b e $ s t a $ s l a k $ t e $ " r i: $ e t
arbetsgivarrepresentanter	" " a r $ b e: t s $ j i: $ v a r $ r e $ p r e $ s e n $ % t a n $ t e r
sjutiofem	" " x\ }: $ t I $ U $ " f e m
ankommet	" " a n $ % k O $ m e t
kemikaliska	s' e $ m I $ " " k A: $ l I $ s k a
bortrivet	" " b O t` $ % r i: $ v e t
undesökningar	" " u0 n $ d e $ % s 2: $ k n I N $ a r
mnä	m n E:
kundämne	" " k u0 n d $ % e m $ n e
hovmästarn	" " h o: v $ % m e $ s t a n`
därfr	d E: r $ " " f r o: n
nämt	" n e m t
tvåhundratusen	t v o: $ h u0 n $ d r a $ % t }: $ s e n
skansken	" " s k a n $ s k e n
buffèn	" " b u0 $ f e e: n
esper	" " e $ s p e r
cir	s i: $ a j $ " " e r
allmänvetenskap	" " a l $ m e n $ v e: $ t e n $ % s k A: p
character	x\ a $ " r a k $ t e r
föreningsteknik	f 9 r $ " " e: $ n I N s $ t e $ % k n i: k
tvättrådet	" " t v e t $ % r o: $ d e t
ssom	s O m
generalerna	j e $ n e $ " r A: $ l e $ n` a
undebara	" " u0 n $ d e $ % b A: $ r a
light	" l a j t
psi	p e: $ e s $ " i:
pepparkaker	" " p e $ p a r $ % k A: $ k e r
svetsfel	" " s v e t s $ % f e: l
sejer	" s e $ j e r
kiltkjol	" k I l t $ % s' u: l
brödkaker	" " b r 2: d $ % k A: $ k e r
flame	" " f l A: $ m e
båj	" " b O j
personvagnsunderhåll	p e $ " " s` u: n $ % v a N n s $ u0 n $ d e r $ % h O l
stand	s t E: n d
knepiare	" " k n e: $ p I $ a $ r e
kulturjord	k u0 l $ " " t }: r $ % j u: d`
sprängabasen	" " s p r e N $ a $ % b A: $ s e n
klarlagt	" " k l A: $ % l` a k t
emp	" " e m p
vörndad	" " v 2: n` $ d a d
amrikanst	" a m $ r I $ " k a n s t
slinger	" " s l I N $ e r
hundranittionio	" " h u0 n $ d r a $ n I $ t I $ U $ " " n i: $ U
ov	" " u: $ v e:
stun	" s t u0 n
redbergsbladet	" " r e: d $ b e r j s $ % b l A: $ d e t
skittråkigt	" " x\ i: t $ % t r o: $ k I k t
vassego	v a $ " s e: $ g U
brevena	" b r e: $ v e $ n a
fruktbart	" " f r u0 k t $ % b A: t`
nittonhundratrettiosex	" " n I $ t O n $ h u0 n $ d r a $ t r e $ t I $ U $ " s e k s
shadowrun	" s` e $ d O v $ r u0 n
ingergerd	" " I N $ e r $ j E: d`
nnä	" n E:
kuvertväsker	k }: $ " " v E: r $ % v e $ s k e r
görsvårt	" " j 2: r $ % s v o: t`
etthundratie	e t $ h u0 n $ d r a $ " " t i: $ e
speciali	s p e $ s I $ " " A: l $ i:
röder	" " r 2: $ d e r
räknen	" " r E: $ k n e n
taler	" " t A: $ l e r
föfäkta	" " f 2: $ % f e k $ t a
kashgaimatta	k a $ " " s` g e j m a $ t a
tamagotchi	t a $ m a $ " g O t $ s' I
sz	s`
jaf	" j A: f
elbehov	" " e l $ b e $ % h u: v
levnadssätte	" " l e: v $ n a t s $ % s e $ t e
paller	" p a $ l e r
dätta	" d e $ t a
uppmuntrande	" " u0 p $ % m u0 n $ t r a n $ d e
uppfölning	" " u0 p $ f 9 l $ n I N
free	" f r i:
gödslat	" " j 9 t $ s l a t
casa	k a $ s a
vasaskolan	" " v A: $ s a $ % s k u: $ l a n
koninski	k O $ n I n $ s k I
elgapet	" " e: l $ % g A: $ p e t
ytt	" " Y t
femårsverksamhet	" " f e m $ o: s` $ v e r k $ s a m $ % h e: t
solkraftverk	" " s u: l $ k r a f t $ % v e r k
tvåtusentvå	t v o: $ " " t }: $ s e n $ % t v o:
tvivelaktiga	" " t v i: $ v e l $ % a k $ t I $ g a
rapportpaket	r a $ " " p O t` $ p a $ % k e: t
datoj	" " d A: $ t O j
fölk	" f 9 l k
ettus	e t $ " t }: s
ruski	" " r u0 $ s k I
overt	" " u: $ v e t`
groder	" " g r u: $ d e r
organisationsuppföljning	O r $ g a $ n I $ s a $ " " x\ u: n s $ u0 p $ % f 9 l j $ n I N
presskonferans	" " p r e s $ k O n $ f e $ % r a n s
tillbedes	" " t I l $ % b e: $ d e s
skojit	" " s k O $ j I t
småskratt	" " s m o: $ % s k r a t
personalredovisning	p e $ s` U $ " " n A: l $ r e: $ d U $ % v i: $ s n I N
klera	" k l e: $ r a
garan	" " g A: $ r a n
migras	m I $ " g r A: s
lannvetter	" l a n $ v e $ t e r
jämföre	" " j e m $ % f 2: $ r e
jämställd	" " j e m $ s t e l d
åstakommit	o: $ s t a $ % k O $ m I t
snä	" s n E:
inbördes	" " I n $ b 2: $ d` e s
blö	" " b l 2:
delfinkultur	d e l $ " " f i: n $ k u0 l $ % t }: r
hundraelva	" " h u0 n $ d r a $ " " e l $ v a
multimodal	" " m u0 l $ t I $ m O $ % d A: l
billi	" " b I $ l I
bety	b e $ " t y:
tomorrow	t U $ " " m O $ r O v
rocagil	r U $ " k A: $ g I l
kvalitetssystemet	k v a $ l I $ " " t e: t s $ s Y $ % s t e: $ m e t
tryckta	" " t r Y k $ t a
sjukanmält	" " x\ }: k $ a n $ % m E: l t
elegantta	e $ l e $ " g a n $ t a
öglorna	" " 2: $ g l U $ n` a
fashinerande	f a $ s` I $ " n e: $ r a n $ d e
birdoj	" b 2: $ d` O j
naah	" n A:
felena	f e $ " " l e: $ n a
liste	" " l I $ s t e
hallbyrå	" " h a l $ % b y: $ r o:
anonymiserat	a $ n U $ n Y $ m I $ " s e: $ r a t
sjuhålingen	x\ }: $ " h o: $ l I N $ e n
förlängningsskaft	f 9 $ " " l` e N $ n I N s $ % s k a f t
lämner	" " l e m $ n e r
rappberg	" " r a p $ % b e r j
stadsdelskapellet	" " s t a t s $ d e: l s $ k a $ % p e $ l e t
motsäjer	" " m u: t $ s e $ j e r
uppstad	" " u0 p $ % s t A: d
hddiskett	" " h o: $ % d e: $ d I $ % s k e t
somewhere	" s O $ m e $ " v E: r
drinte	" " d r I n $ t e
nåå	" n o:
lovelace	" " l u: $ v e $ l a s
påst	" " p O s t
interesting	I n $ t e $ " " s` t` I N
taxekonstruktionen	" " t a k $ s e $ k O n $ s t r u0 k $ % x\ u: $ n e n
telmed	t e $ l e $ " m e: d
förlamad	f 9 $ " l` A: $ m a d
al-fab-et-o	A: $ e l $ f a b e t $ % u:
before	b e $ " " f o: r
nittonhundraåttioett	" " n I $ t O n $ h u0 n $ d r a $ O $ t I $ U $ " e t
nedrans	" " n e: $ d r a n s
feltvättad	" " f e: l $ % t v e $ t a d
vinkultur	" " v i: n $ k u0 l $ % t }: r
grosjean	g r U $ " s` A: n
ingengör	" " I N $ e n $ % j 2: r
underhållsstyrningen	" " u0 n $ d e r $ h O l s $ % s t y: $ n` I N $ e n
oriktat	" " u: $ % r I k $ t a t
fs	f s
unbound	}: $ e n $ " " b a*U n d
sign	" s I N n
beredskapsplanering	b e $ " " r e: d $ s k A: p s $ p l a $ % n e: $ r I N
undesökning	u0 n $ d e s $ % 2: $ k n I N
artelleri	a $ " t` e $ l e $ % r i:
vx	" v e k s
pirri	" " p I $ r I
språkanvänningar	" " s p r o: k $ a n $ % v e $ n I N $ a r
affärsförhandlingen	a $ " " f E: s` $ f 9 r $ % h a n d $ l I N $ e n
nollnoll	" " n O l $ " n O l
njao	" " n j A: $ U
igångan	I $ " " g O N $ a n
energikä	e $ n e r $ " " x\ i: $ % s' E:
äö	2:
samordningsansvaria	" " s a $ m o: d` $ n` I N s $ a n $ % s v A: $ r I $ a
elocutio	e $ l O $ k u0 $ t I $ U
arbetstjänst	" " a r $ b e: t s $ % s' e n s t
rutinbeskrivning	r }: $ " " t i: n $ b e $ % s k r i: v $ n I N
energiverkena	e $ n e r $ " " x\ i: $ % v e r $ k e $ n a
grejsimojs	" g r e j $ s I $ m O j s
åg	o: g
hey	h e j
combat	" k O m $ b a t
uppenbarlien	" " u0 $ p e n $ % b A: $ l` I n
restrektiv	" " r e s t $ % r e k $ % t i: v
ligge	" " l I $ g e
tisxljar	" t I s k s l $ j a r
again	a $ g a $ " i: n
svårighetsnivåer	" " s v o: $ r I g $ h e: t s $ n I $ % v o: $ e r
lunger	" " l u0 N $ e r
markets	" m A: r $ k e t s
naturlitvis	n a $ " " t }: r $ l` i: t $ % v i: s
listera	l I $ " s t e: $ r a
nype	" n y: $ p e
blat	" b l a t
fade	f a $ d e
jägermeister	" " j E: $ g e r $ " m e j $ s t e r
schematiserat	x\ e $ m a $ t I $ " s e: $ r a t
jaj	" j a j
tje	" s' e
jupare	j }: $ p a $ r e
korrulat	k O $ r u0 $ " l A: t
cloroben	k l O $ " r o: $ b e n
mötande	" " m 2: $ t a n $ d e
tve	" " t v e:
lokalklimatet	l U $ " " k A: l $ k l I $ % m A: $ t e t
överabstraktion	" " 2: $ v e $ r a p $ s t r a k $ " x\ u: n
jäk	" j E: k
hagalunn	h A: $ g a $ " l u0 n
olyan	" " u: $ % l y: $ a n
tennlampan	" " t e n $ % l a m $ p a n
uppräknat	" " u0 p $ % r E: $ k n a t
jourbyråns	" " x\ u: r $ % b y: $ r o: n s
utleveransen	" " }: t $ l e $ v e $ % r a n $ s e n
lillköp	" " l I l $ % s' 2: p
markluftsradarn	" " m a r k $ l u0 f t s $ r A: $ d a n`
metutrustning	" m e t $ }: t $ % r u0 s t $ n I N
planter	" " p l a n $ t e r
fortynine	f O $ " " t` y: $ n I n
apberget	" " A: p $ % b e r $ j e t
lastbischåfför	" " l a s t $ b i: $ % s` O $ " f 2: r
skalihet	s k a $ " l i: $ h e: t
videobandinspelningen	" " v i: $ d e $ U $ b a n d $ I n $ % s p e: l $ n I N $ e n
booked	" b u: k d
even	" " e: $ v e n
egent	e $ " j e n t
stirrit	" " s t I $ r I t
äää	E: E
veckomässa	" " v e $ k U $ % m e $ s a
matter	" m a $ t e r
bates	b a $ " t e: s
fördelaktigare	" " f 2: $ d` e: l $ % a k $ t I $ g a $ r e
gnälli	" " g n e $ l I
praksis	" p r a k $ s I s
aktiebolage	" " a k t $ s I $ e $ b u: $ l A: $ g e
rydsvik	" " r y: d s $ % v i: k
sånahära	" s O $ n a $ % h E: $ r a
problemmet	p r U $ " " b l e: m $ m e t
logopedmottagning	l O $ g U $ " p e: d $ m u: t $ % t A: $ g n I N
toryledamot	" " t o: $ r Y $ l e: $ d a $ % m u: t
dagverksamheter	" " d A: g $ v e r k $ s a m $ % h e: $ t e r
vägglampetter	" " v e g $ % l a m $ % p e $ t e r
viktigste	" " v I k $ t I k $ s t e
ssch	s`
strängerna	" s t r e N $ e $ n` a
uttryckta	" " }: t $ % t r Y k $ t a
iom	i: $ u: $ " e m
joda	" j u: $ d a
diariefört	d I $ " " A: $ r I $ e $ % f 2: t`
sjugrejen	" " x\ }: $ % g r e $ j e n
åttinio	" " O $ t I $ n I $ O
trygghansas	" " t r Y g $ h a n $ s a s
tidit	" " t i: $ d I t
tjusex	" " s' }: $ s e k s
sjuhålare	x\ }: $ " h o: $ l a $ r e
kostfrågorna	" " k O s t $ % f r o: $ g U $ n` a
programhandeln	p r U $ " " g r a m $ % h a n $ d e l n
nobody	" n o: $ b O $ d Y
true	" " t r }: $ e
skoji	" " s k O $ j I
konferansrum	k O n $ f e $ " " r a n s $ % r u0 m
lets	" l e t s
such	" s u0 k
väljes	" " v e l $ j e s
arb	" a r b
snedvridna	" " s n e: d $ % v r i: d $ n a
flensburg	" " f l e: n s $ b u0 r j
frankie	" f r a N $ k I
öveblick	" " 2: $ v e $ % b l I k
maskroser	" " m a s k $ % r u: $ s e r
cityenheten	" " s I $ t Y $ e: n $ % h e: $ t e n
booking	" b u: $ k I N
däras	" d E: $ r a s
återbesökstid	" " o: $ t e r $ b e $ % s 2: k s $ % t i: d
millimet	m I $ l I $ " " m e: t
upptäcke	" " u0 p $ % t e $ k e
inväningar	" " I n $ % v e $ n I N $ a r
taliganmatta	t a $ l I $ " " g A: n $ % m a $ t a
tjäne	s' E: $ n e
uppdragsläget	" " u0 p $ d r A: g s $ % l E: $ g e t
nominalisering	" " n o: $ m I $ n a $ l I $ % s e: $ r I N
oljekraft	" " O l $ j e $ % k r a f t
lingvo	l I N $ v U
uppbyggda	" " u0 p $ % b Y g $ d a
vänje	" " v e $ n j e
afeba	a $ f e $ " b a
hundrasex	" " h u0 n $ d r a $ " s e k s
hypotestestande	h Y $ p O $ " " t e: s $ % t e $ s t a n $ d e
gn	" g n
tåschedå	" " t o: $ % x\ e: $ d O
altaälven	" " a l $ t a $ % e l $ v e n
önyx	" " 2: $ n Y k s
morgonflyget	" " m O r $ g O n $ % f l y: $ g e t
slipere	" s l i: $ p e $ r e
användarproblem	" " a n $ v e n $ d a r $ p r U $ % b l e: m
resonemange	r e $ s U $ n e $ % m a N $ e
tösse	" t 9 $ s e
övernaturlighet	" " 2: $ v e r $ n a $ t }: r $ l` I g $ h e: t
invid	I n $ " v i: d
juliagustinumret	j }: $ l I $ " A: $ g u0 $ " s t i: $ n u0 m $ r e t
implementation	I m $ p l e $ m e n $ t a $ " x\ u: n
slaktari	" " s l a k $ t a $ r I
vinylglans	v I $ " " n y: l $ % g l a n s
societo	s U $ s I $ e $ " " t o:
jå	" j O
bemanningsarbete	b e $ " m a $ n I N s $ a r $ % b e: $ t e
jahomma	j A: $ " h O $ m a
konferans	k O n $ f e $ r a n s
veg	" " v e: g
hoho	" h u: $ h U
skitsaken	" " x\ i: t $ % s A: $ k e n
hemländska	" " h e m $ % l e n d $ s k a
mea	m e $ " A:
henn	" " h e n
atenium	a $ " " t e: $ n I $ u0 m
jättenyttigt	" " j e $ t e $ % n Y $ t I k t
karachi	k a $ " r a $ k I
peda	p e $ d a
decision	d e $ s I $ " x\ u: n
hårtvätt	" " h o: $ % t` v e t
hejmter	h e j $ " " e m $ t e r
slirkoppling	" s l I r $ k O $ p l I N
parkerad	p a r $ " k e: $ r a d
språkpsykolog	" " s p r o: k $ p s Y $ k U $ % l o: g
matsalsstolar	" " m A: t $ s A: l s $ % s t u: $ l a r
jordbrukstraditioner	" " j u: d` $ b r }: k s $ t r a $ d I $ % x\ u: $ n e r
oförenligheten	" " u: $ f 9 r $ " e: n $ l I g $ % h e: $ t e n
fredligt	" " f r e: d $ l I k t
sörje	" " s 9 r $ j e
pioneers	p a $ j U $ " n e: s`
ägd	% E: g d
svettiskort	" s v e $ t I s $ % k U t`
ortviken	" " U t` $ % v i: $ k e n
odödli	" " u: $ % d 2: d $ l I
nach	" n a $ t s'
tjugefyra	" " s' }: $ g e $ " " f y: $ r a
splittrande	" " s p l I $ t r a n $ d e
solesjön	" " s u: l $ e $ % x\ 9 n
lupoj	l }: $ " " p O j
färgmomentet	" " f e r j $ m U $ % m e n $ t e t
pehöver	p e $ " h 2: $ v e r
treårs	" " t r e: $ % o: s`
arbetsersättning	" " a r $ b e: t s $ e: $ % s` e t $ n I N
numb	n u0 m $ " b e:
trendsättande	" " t r e n d $ % s e $ t a n $ d e
naha	n a $ " h A:
ackoderat	a $ " k o: $ d e: $ r a t
utfrågad	" " }: t $ % f r o: $ g a d
sextusenfemhundra	s e k s $ " t }: $ s e n $ % f e m $ " h u0 n $ d r a
giktattack	" " j I k t $ a $ % t a k
biti	" " b I $ t I
människokultur	" " m e $ n I $ x\ U $ k u0 l $ % t }: r
konventionaliserat	k O n $ v e n $ x\ U $ n a $ l I $ % s e: $ r a t
löneklassera	" " l 2: $ n e $ k l a $ " s e: $ r a
kejsarvåfflor	" " s' e j $ s a r $ % v O $ f l U r
prutsystem	" " p r }: t $ s Y $ % s t e: m
communio	k O m $ j }: $ n I $ O
nidafors	" " n i: $ d a $ " f O s`
jätteviktig	" " j e $ t e $ % v I k $ t I g
herberta	" h e r $ b e $ t` a
föruttsättningar	f 9 r $ " u0 t $ % s e t $ n I N $ a r
tomteterrin	" " t O m $ t e $ t e $ % r i: n
joa	" " j u: $ a
riesenthal	" r i: $ s e n $ t A: l
sought	" s u: g t
uppen	" " u0 $ p e n
qpop	" k }: $ " p O p
ballast	" " b A: $ l a s t
klandjuret	" " k l A: n $ % j }: $ r e t
penicilin	p e $ n I $ s I $ " l i: n
ahm	" " A: m
tune	" t }: $ n e
dataaffären	" " d A: $ t a $ a $ % f E: $ r e n
jälp	" j e l p
dannmark	" " d a n $ % m a r k
föknippa	f 9 $ % k n I $ p a
folkpartit	" " f O l k $ p a $ t` i: t
bristfälli	" " b r I s t $ % f e $ l I
uppstånne	" " u0 p $ s t O $ n e
tvåhun	t v o: $ h u0 n
ikke	I $ k e
personalhandläggarna	p e $ s` U $ " " n A: l $ h a n d $ % l e $ g a $ n` a
förtiofem	" " f 2: $ t` I $ U $ " f e m
tuffis	" " t u0 f $ % i: s
kulturlig	k u0 l $ " " t }: r $ l` I g
crownes	" k r a*U n s
roomservicen	" r u: m $ % s 9 r $ v I $ s e n
stöttdämpare	" " s t 9 t $ % d e m $ p a $ r e
frang	" f r a N
manövrar	m a $ " n 2: $ v r a r
etthundrafyrtionie	e t $ h u0 n $ d r a $ f 9 $ t` I $ U $ " " n i: $ e
artellerigatan	a $ " t` e $ l e $ r I $ % g A: $ t a n
mansäjer	m a n $ " " s e $ j e r
originalstoryn	O $ r I $ g I $ " " n A: l $ s t u: $ r Y n
busstabell	" " b u0 s $ t a $ % b e l
feel	" f i: l
turtlewaxet	" " t }: $ t` l e: v a k $ s e t
funnes	" " f u0 $ n e s
mühlers	" m y: $ l e s`
kungsportsavenyn	" " k u0 N s $ % p U t` s` $ a $ v e $ " n y: n
affärssj	a $ " " f E: $ s` s`
kollektivets	k O $ l e k $ t i: $ v e t s
förboka	" " f 2: r $ % b u: $ k a
personalkostnadsdelen	p e $ s` U $ " " n A: l $ % k O s t $ n a t s $ % d e: $ l e n
allemans	" " a $ l e $ m a n s
kankkunen	" k a N $ k U $ n e n
hälsovårdsordningen	" " h e l $ s U $ v o: d` s` $ % o: d` $ n` I N $ e n
knivställ	" " k n i: v $ % s t e l
indexfinansierade	" " I n $ d e k s $ f I $ n a n $ s I $ % e: $ r a $ d e
avidär	a $ v I $ " d E: r
hjaa	" " h o: $ j A:
höppes	" h 9 $ p e s
jättepinsamt	" " j e $ t e $ % p i: n $ s a m t
tactics	" t a k $ t I k s
underkänd	" " u0 n $ d e r $ % s' e n d
cst	k s t
sla	" s l a
trägårdsföreningen	" t r E: $ g o: d` s` $ f 9 r $ % e: $ n I N $ e n
tvåtusensextio	t v o: $ " " t }: $ s e n $ % s e k $ s t I $ U
gurkplantan	" " g u0 r k $ % p l a n $ t a n
ein	" e j n
dissikera	d I $ s I $ " k e: $ r a
beslutsmöte	b e $ " " s l }: t s $ % m 2: $ t e
sallat	" " s a $ l a t
malayer	" " m A: $ l a $ j e r
cyber	" s a j $ b e r
kulturlag	k u0 l $ " " t }: r $ % l` A: g
varandres	v a $ " r a n $ d r e s
svå	" s v o:
plåtdörr	" " p l o: t $ % d 9 r
speci	" s p e: $ s e: $ " i:
fleuron	f l E*U $ r O n
hemlis	" " h e m $ % l i: s
skaligheten	" s k A: $ l I g $ % h e: $ t e n
main	" m a j n
inväning	" " I n $ % v e $ n I N
floor	" f l o: r
satzbau	" s a t s $ b a*U
gratistelefon	" " g r A: $ t I s $ t e $ l e $ % f o: n
åtefunnen	" " o: $ t e $ " " f u0 $ n e n
uppjenom	" " u0 p $ x\ e $ " n o: m
tst	t s t
uuuppp	" }: a p p
presentationshandling	p r e $ s e n $ t a $ " " x\ u: n s $ % h a n d $ l I N
ångexplosioner	" O N $ e k $ s p l U $ % x\ u: $ n e r
xelot	k s e $ " l u: t
parasitverksamhet	p a $ r a $ " " s i: t $ v e r k $ s a m $ % h e: t
newyork	n j U $ " j o: k
learning	" l i: $ n` I N
grundhyra	" " g r u0 n d $ % h y: $ r a
sibiu	s I $ " b i: $ " }:
klinikledningen	k l I $ " " n i: k $ % l e: d $ n I N $ e n
uppfa	" " u0 p $ f a
västerdata	v e $ s t e $ " " d` A: $ t a
kolbit	" " k o: l $ % b i: t
horrors	" h O $ r U s`
lekhallar	" " l e: k $ % h a $ l a r
deres	d e $ " r e: s
åteställa	" " o: $ t e $ % s t e $ l a
sängkt	" " s e N $ k t
loci	" " l u: $ k I
majnumret	" " m a j $ % n u0 m $ r e t
pucko	" " p u0 $ k U
alldelens	" " a l $ % d e: $ l e n s
moving	" m u: $ v I N
framte	" " f r a m $ t e
namm	" " n a m n
planning	p l a $ n I N
nön	" n 9 n
teaching	" " t i: s` I N
talking	" " t a l $ k I N
känslena	" " s' e n $ s l e $ n a
skö	" s k 2:
nittisju	n I $ t I $ " " x\ }:
uppodlad	" " u0 p $ % u: d $ l a d
nak	" n A: k
datorskärm	" " d A: $ t U r $ % x\ e r m
amazonasdjungeln	a $ m a $ " s o: $ n a s $ % j u0 N $ e l n
kauntri	" k a*U n $ t r I
arist	a $ " r I s t
gelmojden	" " j e: l $ % m O j $ d e n
pelarn	p e $ l a n`
individmärkta	I n $ d I $ " v i: d $ m e r k $ t a
ettusenfemtio	e t $ " t }: $ s e n $ " f e m $ t I $ U
fran	" f r a n
låte	" " l o: $ t e
fiftyfour	f I f $ t Y $ f u: r
silvergruver	" " s I l $ v e r $ % g r }: $ v e r
iskarameller	" " i: s $ k a $ r a $ % m e $ l e r
utnyttjad	" " }: t $ % n Y t $ j a d
vasaförsäkring	" " v A: $ s a $ f 9 $ % s` E: $ k r I N
gazeto	" " g A: $ s e $ t U
jäla	" " j E: $ l a
intake	I n $ " t a $ k e
shuttle	" s` U $ t e l
stjärtlyft	" " x\ e t` $ % l` Y f t
reaches	r e $ " " a s`
däär	d E: r
ändre	" e n $ d r e
årsprognos	$ o: s` $ p r U $ % g n o: s
eehm	" e: m
hamburgarn	" " h a m $ b }: r $ j a n`
artonårinar	" " A: $ t` O n $ % o: $ r i: $ n a r
kvällsuthyrningen	" " k v e l s $ }: t $ % h y: $ n` I N $ e n
koffel	" k O $ f e l
styrprincipen	" " s t y: r $ p r I n $ % s i: $ p e n
syssler	" " s Y $ s l e r
grejjen	" g r e j $ % j e: n
byggnadslagsstiftningen	" " b Y $ g n a t s $ l A: g s $ % s t I f t $ n I N $ e n
pygmeerna	p Y g $ " m e: $ e $ n` a
övegår	" " 2: $ v e $ % g o: r
dibåj	d I $ " " b O j
siffrerna	" " s I $ f r e $ n` a
morronflyget	" " m O $ r O n $ % f l y: $ g e t
gff	g e: $ e f $ " e f
affä	a $ " " f E:
håh	h o: $ " h o:
protokollsbeslut	p r U $ t U $ " " k O l s $ b e $ % s l }: t
akti	" a k $ t i:
ront	r O n t
studentrabatt	s t }: $ " " d e n t $ r a $ % b a t
juder	" " j }: $ d e r
långkalsingar	" " l O N $ k a l $ s I N $ a r
motionskort	m U t $ " " x\ u: n s $ % k U t`
undelag	" " u0 n $ d e $ % l A: g
enk	e N $ " k o:
behöve	b e $ " h 2: $ v e
npr	e n $ p e: $ " e r
måndan	" m O n $ d a n
tibakavägen	t I $ " " b A: $ k a $ % v E: $ g e n
exet	e k $ s e t
jettebra	j e $ " " t e: $ b r a
nittonhundratrettiotvå	" " n I $ t O n $ h u0 n $ d r a $ t r e $ t I $ U $ " t v o:
ihög	" " i: $ % h 2: g
inrikes	" " I n $ r i: $ k e s
innersvetsen	" " I $ n e $ % s` v e t $ s e n
én	e: n
ungdomsbiljett	" " u0 N $ d U m s $ b I l $ % j e t
lovely	l U $ " v e: $ l Y
uppskjutet	" " u0 p $ % x\ }: $ t e t
föstår	" " f 2: $ s t o: r
diskriminerande	d I $ s k r I $ m I $ % n e: $ r a n $ d e
op	" " u: p
lindgren	" " l I n d $ % g r e: n
rymdkolonier	" " r Y m d $ k O $ l U $ % n i: $ e r
koverta	k U $ " v e $ t` a
kvalitetsmöte	k v a $ l I $ " " t e: t s $ % m 2: $ t e
njaha	" " n j A: $ h a
biståndsbeslutet	" " b i: $ s t O n d s $ b e $ % s l }: $ t e t
metallmuggar	m e $ " " t a l $ % m u0 $ g a r
neuchåtel	n e: $ }: $ " s` o: $ t e l
amiga	a $ " m i: $ g a
fiskekrogen	" " f I $ s k e $ % k r u: $ g e n
que	k
beluttjen	b e $ " l u0 t $ j e n
bortstad	" " b O t` $ % s` t` a d
bokningsnumret	" " b u: $ k n I N s $ % n u0 m $ r e t
avstämt	" " A: v $ % s t e m t
logopedutbildningen	l O $ g U $ " p e: d $ }: t $ % b I l d $ n I N $ e n
didnt	" " d i: $ d e n t
uuu	u0 u:
bamyl	b a $ " m y: l
kattbringaren	" " k a t $ % b r I N $ a $ r e n
krattat	" " k r a $ t a t
nånslags	" n O n $ s l A: g s
hate	" h A: $ t e
laesö	l e $ " s 2:
domine	d U $ " m I $ n e
should	" x\ o: l d
disketthanteringen	d I $ " " s k e t $ h a n $ % t e: $ r I N $ e n
fömedla	f 9 $ " m e: d $ l a
blo	b l U
endera	e n $ " d e: $ r a
ladak	" " l A: $ d a k
gallerimattan	g a $ l e $ " " r i: $ % m a $ t a n
vattenfrågan	" " v a $ t e n $ % f r o: $ g a n
paternosterkyrkan	p A: $ t e $ " " n` O $ s t e r $ % s' Y r $ k a n
grusbo	" " g r }: s $ b u:
majeure	m a $ j e $ " v r e:
stickad	" " s t I $ k a d
åo	" " o: $ U
ståltrå	" " s t o: l $ t r o:
fasten	" " f a $ s t e n
sad	" s a d
nämnligen	" " n e m n $ l I $ g e n
worst	" v 2: s` t`
datapoints	" " d A: $ t a $ p U $ " e N s
everyone	" e $ v e $ r I $ O $ n e
flugsnapparn	" " f l }: g $ % s n a $ p a n`
tesexempel	" t e s $ e k $ % s e m $ p e l
förvaltningscheferna	f 9 r $ " " v a l t $ n I N s $ % x\ e: $ f e $ n` a
bomsalver	" " b O m $ % s a l $ v e r
ste	" s t e
restagård	" " r e $ s t a $ % g o: d`
thing	" " t I N
avgrundsvänstern	" " A: v $ g r u0 n d s $ % v e n $ s t e n`
isonoti	i: $ s O $ " n o: $ t I
santta	" s a n $ t a
saints	s a N s
ändhålen	" e n d $ % h o: $ l e n
energianläggningar	e $ n e r $ " " x\ i: $ a n $ % l e $ g n I N $ a r
överhu	" " 2: $ v e r $ h U
språklihet	" " s p r o: $ k l I $ h e: t
hursa	" h U $ s` a
trevlit	" " t r e: v $ l I t
bai	" b a j
gilti	" " j I l $ t I
distriktstyrelsen	d I $ " " s t r I k t $ % s t y: $ r e l $ s e n
kulturinslag	k u0 l $ " " t }: r $ I n $ % s l A: g
omet	" " u: $ m e t
sjuttiosjuan	x\ u0 $ t I $ U $ " x\ }: $ a n
quicker	" k v I $ k e r
väggtallrikar	" " v e g $ % t a l $ r I $ k a r
dagskonferens	" " d a k s $ k O n $ f e $ % r a n s
bergådalbana	" " b e r j $ o: $ " " d A: l $ % b A: $ n a
finstrimling	" " f i: n $ % s t r I m $ l I N
hönet	" " h 2: $ n e t
naturresuser	n a $ " " t }: r $ r e $ s u0 $ s e r
sprajt	" s p r a j t
käns	" k e n
bolof	b U $ l O f
törka	" t 9 r $ k a
rollstrukturen	" r O l $ s t r u0 k $ % t }: $ r e n
dwarf	d v a r v
nödvädigt	" " n 2: d $ v E: $ d I k t
glömer	" " g l 9 $ m e r
capoten	k a $ p U $ t e n
could	k U $ " l d
förrådsfolk	f 9 r $ " " r o: d s $ % f O l k
personförsäkringar	p e $ " " s` u: n $ f 9 $ % s` E: $ k r I N $ a r
jajemensan	" " j a $ j e $ % m e n $ s a n
åteställer	" " o: $ t e $ % s t e $ l e r
hundratre	" " h u0 n $ d r a $ " t r e:
ungdomsenheten	" " u0 N $ d U m s $ e: n $ % h e: $ t e n
oän	u: $ " e n
storskolan	" " s t u: $ % s` k u: $ l a n
fillmore	" " f I l $ m o: r
beredsskapsarbetare	b e $ " r e: d $ s k A: p s $ a r $ % b e: $ t a $ r e
cba	s e: $ b e: $ " A:
hikmet	" h i: k $ m e t
hindrad	" " h I n $ d r a d
handbook	" " h a n d $ b U k
femtontiden	" " f e m $ t O n $ % t i: $ d e n
stravinski	s t r a $ " v I n $ s k I
åtekomma	" " o: $ t e $ % k O $ m a
planlagt	" " p l A: n $ % l a k t
naturenresurs	n a $ " " t }: r $ % e: n $ r e $ % s u0 s`
förstelnad	f 9 $ " s` t` e: l $ n a d
tjugoandre	s' }: $ g U $ " " a n $ d r e
fakturaunderlagen	f a k $ " " t }: $ r a $ u0 n $ d e $ % l` A: $ g e n
sommarkafé	" " s O $ m a r $ k a $ % f e:
stöu	" " s t 2: $ u0
idèer	i: $ d e: $ " e: e r
naturbegreppet	n a $ " " t }: r $ b e $ % g r e $ p e t
åss	O s
fjort	" " f j U t`
skolteve	" " s k u: l $ % t e: $ v e:
exempe	e k $ " s e m $ p e
andrasats	" " a n $ d r a $ % s a t s
excuse	e k $ s u0 s
sugeffekten	" " s }: g $ e $ % f e k $ t e n
treordsnivån	" " t r e: $ U d` s` $ n` I $ % v o: n
såndärnt	" s O n $ d e n` t`
hönsskit	" " h 9 n s $ % x\ i: t
beloppena	b e $ " l O $ p e $ n a
troserna	" " t r u: $ s e $ n` a
stajl	s t a $ " " j e l
brottarhjärna	" " b r O $ t a r $ % j E: $ n` a
vänst	" v e n s t
procedurall	p r U $ s e $ " d }: $ r a l
svarsfrekvens	" " s v A: s` $ f r e $ % k v e n s
provtvätta	" " p r u: v $ % t v e $ t a
died	" d i: d
törsti	" " t 9 $ s` t` I
engångs	" " e: N $ % g O N s
nerköp	" " n e: r $ % s' 2: p
aco	" A: $ k U
verksamhetsspecifika	" " v e r k $ s a m $ h e: t s $ s p e $ s I $ % f i: $ k a
rågummiskor	" " r o: $ g u0 $ m I $ % s k u: r
langues	l a N $ " g e s
förfärli	f 9 r $ " f E: $ l` I
afghanbeluch	a f $ " " g A: n $ b e $ " l u0 t s'
ordsammanställningar	" " u: d` $ s` a $ m a n $ % s t e l $ n I N $ a r
hårshampot	" " h o: $ % x\ a m $ p U t
elller	e $ " " l l e r
deler	" " d e: $ l e r
sextisju	" " s e k $ s t I $ " x\ }:
kaffeplantager	" " k a $ f e $ p l a n $ % t A: $ s` e r
bdra	" " b e: $ % d r A:
sesa	" s e: $ s a
ägghönan	e g $ % h 2: $ n a n
gajba-sigy	" " g a j $ b a $ " s i: $ g Y
vocabulario	v O $ k a $ b }: $ " " l A: $ r I $ U
mässigt	" " m e $ s I k t
rules	r }: $ l e s
äp	E: p
e1	" " e: $ % e t
blandyrken	" " b l a n d $ % Y r $ k e n
vansinnesutbrott	" " v A: n $ s I $ n e s $ }: t $ % b r O t
ojo	" " u: $ j O
mängdteori	" " m e N d $ t e $ U $ % r i:
strukturo	s t r u0 k $ t }: $ r U
sjuttsex	x\ u0 $ t $ " s e k s
utnyttj	" " }: t $ n Y t j
heavy	" h i: $ v Y
avensjö	" " A: $ v e n $ % x\ 2:
lokoj	l U $ " k O j
plocker	" " p l O $ k e r
biluthyrningsfirman	" " b i: l $ }: t $ % h y: $ n` I N s $ % f I r $ m a n
muzika	m u0 $ " s i: $ k a
kuvertväskena	k }: $ " " v E: r $ % v e $ s k e $ n a
lassarettet	" " l a $ s a $ % r e $ t e t
kise	" s' i: $ s e
vilj	" v I l j
elektrostencil	e $ l e k $ t r U $ " s t e n $ " s i: l
bordsbeställning	" " b u: d` s` $ b e $ % s t e l $ n I N
malay	m a $ " l a j
medmerarabatt	" " m e: d $ m e $ r a $ r a $ % b a t
spegulpagxe	" " s p e: $ g u0 $ " p a k $ s e
märkmaskin	" " m e r k $ m a $ % x\ i: n
tiita	" t i: $ t a
proclamisseme	p r O $ " k l a $ m I $ % s e: $ m e
temporalt	t e m $ p U $ " r A: l t
tesagt	t e $ " s a k t
programera	p r U $ g r a $ % m e: $ r a
laughter	" l A: f $ t e r
äen	" E: $ e n
färdigställda	" " f E: $ d` I g $ % s t e l $ d a
situationstecken	s I $ t }: $ a $ " " x\ u: n s $ % t e $ k e n
lokalbanken	l U $ " " k A: l $ % b a N $ k e n
exploaterande	e k $ s p l U $ a $ " t e: $ r a n $ d e
yo	j U
nju	" " n j }:
fök	" f 2: k
harmoniserat	h a r $ m U $ n I $ " s e: $ r a t
ajdå	" a j $ d O
innebar	" " I $ n e $ % b A: r
stilbyrå	" " s t i: l $ % b y: $ r o:
groucho	" g r U s` U
imorrnkväll	I $ " " m O n` $ % k v e l
underkastad	" " u0 n $ d e r $ % k a $ s t a d
integrationsprojektet	I n $ t e $ g r a $ " " x\ u: n s $ p r U $ % x\ e k $ t e t
tjylix	" s' y: $ l I k s
brygge	" " b r Y $ g e
komprimerad	k O m $ p r I $ " m e: $ r a d
tomtansökan	" " t O m t $ a n $ % s 2: $ k a n
sjydda	" x\ Y $ d a
inköpskommittén	" " I n $ s' 2: p s $ k O $ m I $ % t e: n
resultatkrav	r e $ s u0 l $ " " t A: t $ % k r A: v
beredsskapsarbetana	b e $ " r e: d $ s k A: p s $ a r $ % b e: $ t a $ n a
salora	" s a $ l O $ r a
neranför	" " n e: r $ a n $ % f 2: r
nåstans	" n O $ s t a n s
trädgårn	" " t r e $ g O n`
riksdan	r I k s $ " d A: n
athén	a $ " t e: n
idla	" " i: d $ l a
socionomutbildningen	s U $ s I $ U $ " " n o: m $ }: t $ % b I l d $ n I N $ e n
tunnelvagnar	" " t u0 $ n e l $ % v a N $ n a r
wal	" v o: l
polemaiska	p U $ l e $ " m E: $ s k a
tjugitredje	" " s' }: $ g I $ " " t r e: d $ j e
gunnareds	" " g u0 $ n a $ r e: d s
sahel	" " s A: $ e l
path	" p a t
nyinköp	" " n y: $ I n $ % s' 2: p
muskelfästet	" " m u0 $ s k e l $ % f e $ s t e t
starletinsändare	" s t A: $ l` e t $ I n $ % s e n $ d a $ r e
quote	" k v u: t
expeditionssak	e k $ s p e $ d I $ " " x\ u: n s $ % s A: k
lisboa	" l i: s $ b u: $ a
stanster	" " s t a n $ s t e r
racid	r a $ " s i: d
tiekroners	" t I $ e: $ k r u: $ n e s`
debiterat	d e $ b I $ " t e: $ r a t
bostjärnan	" " b u: $ % x\ E: $ n` a n
uppskrivet	" " u0 p $ % s k r i: $ v e t
tidsproblem	" " t i: d s $ p r U $ % b l e: m
etos	e $ t U s
förhandlingsbart	f 9 r $ " " h a n d $ l I N s $ % b A: t`
iaktagelser	" " i: $ a k $ % A: $ g e l $ s e r
vaå	" " v A: $ % o:
jättehård	" " j e $ t e $ % h o: d`
fasst	" f a s t
räkne	" " r E: $ k n e
nyo	" " n y: $ u:
lexiko	l e k $ s I $ k U
kvalitativt	k v a $ l I $ t a $ " t i: f t
tvåtusentio	" " t v o: $ % t }: $ s e n $ t I $ U
femmer	" " f e m $ m e r
länskontor	" " l E: n s $ k O n $ % t u: r
samtale	" " s a m $ t A: $ l e
taxigräns	" " t a k $ s I $ % g r e n s
epost	" e: $ p O s t
dammsugarn	" " d a m $ % s }: $ g a n`
smittad	" " s m I $ t a d
jing	" j I N
tvåtusensexhundra	t v o: $ " " t }: $ s e n $ % s e k s $ " h u0 n $ d r a
nöen	" " n 2: $ e n
gröder	" " g r 2: $ d e r
vaan	" v a n
jätteskillnad	" " j e $ t e $ % x\ I l $ n a d
jättedålig	" " j e $ t e $ % d o: $ l I g
känslomässi	" " s' e n $ s l U $ % m e $ s I
kaper	" k A: $ p e r
naturveten	n a $ " " t }: r $ % v e: $ t e n
värderingsmässigt	v e $ " " d` e: $ r I N s $ % m e $ s I k t
panodil	p a $ n U $ " " d i: l
stjärner	" " x\ E: $ n` e r
eä	e $ " E:
valia	" " v A: $ l I $ a
goes	" " g 2: s
bätter	" b e $ t e r
semjanmatta	" " s e: $ m j a n $ % m a $ t a
jätteperfekt	" " j e $ t e $ % p E: r $ % f e k t
fastighetskarta	" " f a $ s t I g $ h e: t s $ % k A: $ t` a
avvaktande	" " A: v $ % v a k $ t a n $ d e
finhackning	" " f i: n $ % h a $ k n I N
högexplosiva	" " h 2: g $ e k $ s p l U $ " s i: $ v a
nackeliden	" " n a k $ e $ % l i: $ d e n
intrasubjektiva	" " I n $ % t r A: $ s u0 $ b j e k $ t i: $ v a
rädioaktiv	" " r e $ d I $ U $ a k $ " t i: v
jättemodernt	" " j e $ t e $ m U $ % d E: n` t`
jamän	j a $ % m e n
emn	e: $ e m $ " e n
tjugonie	s' }: $ g U $ " " n i: $ e
fsns	" " e f $ e s $ e n $ " e s
riktikt	" " r I k $ % t i: k t
oåh	" " u: $ o:
vallien	" v a $ l I $ e n
tekni	t e $ " k n i:
amn	" a m n
minitaxi	" " m i: $ n I $ % t a k $ s I
kvällsflyg	" " k v e l s $ % f l y: g
konfliklösning	k O n $ " f l I k $ l 2: $ s n I N
oo	" o:
mano	m a $ n U
diontisk	d I $ " O n $ t I s k
fles	" f l e s
amaj	a $ " m a j
seglingsföreningen	" " s e: $ g l I N s $ f 9 r $ % e: $ n I N $ e n
chartisterna	x\ a $ " t` I $ s t e $ n` a
kvalitessysteme	k v a $ l I $ " " t e: s $ s Y $ % s t e: $ m e
yllan	" " Y $ l a n
superplingprogrammet	" " s }: $ p e r $ p l I N $ p r U $ % g r a $ m e t
betalningsmottagarens	b e $ " " t A: l $ n I N s $ m u: t $ % t A: $ g a $ r e n s
linnegatan	" " l I $ n e $ % g A: $ t a n
mikaeli	m I $ k a $ " e: $ l I
misstrott	" " m I $ % s t r U t
elprishöjning	" " e: l $ p r i: s $ % h 9 j $ n I N
instr	" I n s t r
ak	a k
föklara	" " f 2: $ % k l A: $ r a
marshallhjälpen	" m A: $ s` 9 l $ % j e l $ p e n
saabia	" s A: $ b I $ a
börj	" " b 9 r j
diskutere	d I $ s k }: $ " t e: $ r e
counting	" " k a*U n $ t I N
brownspråk	" b r a*U n $ s p r o: k
njej	" n j e j
golfbilar	" " g O l f $ % b i: $ l a r
ir	" " I r
flötter	" " f l 9 $ t e r
parkeringsplasserna	p a r $ " " k e: $ r I N s $ % p l a $ s e $ n` a
cfr	" " s e: $ e f $ " e r
hutook	" h u0 t` U k
plastpluppen	" " p l a s t $ % p l u0 $ p e n
trekvartsår	t r e: $ " " k v a t` s` $ % o: r
tibaka	t I $ " b A: $ k a
vattenkastning	" " v a $ t e n $ k a s t $ n I N
vädlit	" " v E: d $ " l i: t
tret	" " t r e: $ % t e:
sience	s I $ " " e n s
redbergspojkar	" " r e: d $ b e r j s $ % p O j $ k a r
immidge	" " I $ m I d s`
nittonhundratju	" " n I $ t O n $ h u0 n $ d r a $ s' }:
algolenius	a l $ g U $ " l e: $ n I $ u0 s
kognitiv	" k O N $ n I $ t i: v
stadsdelsnämndsseminarium	" " s t a t s $ d e: l s $ n e m n d s $ s e $ m I $ % n A: $ r I $ u0 m
pantheon	" p a n t e: $ O n
konka	k O N $ k a
viv	v i: v
ie	I
empatisk	e m $ " p A: $ t I s k
dududu	" d }: $ d }: $ " d }:
pronomenexpriment	p r U $ n U $ m e $ n e k $ s p r I $ " m e n t
sneklippt	" " s n e: $ % k l I p t
jajahomma	" " j a $ j a $ % h U $ m a
bissniss	" " b I s $ % n I s
speler	" s p e: $ l e r
ööh	2:
tjugeåtta	" " s' }: $ g e $ " " O $ t a
skul	" s k }: l
överproducera	" " 2: $ v e r $ p r U $ d }: $ % s e: $ r a
fortune	f O $ " " t` }: $ n e
kashgai	k a $ " " s` g a j
bestraffad	b e $ " s t r a $ f a d
dammråttor	" " d a m $ % r O $ t U r
brandtrappa	" " b r a n d $ % t r a $ p a
aah	" o:
dethära	d e: t E: $ r a
skjussa	" " x\ u0 $ s a
nigra	" " n i: $ g r a
tufu	t }: $ f u0
mnnn	m $ n
ljudkvalité	" " j }: d $ k v a $ l I $ % t e:
satse	" " s a t $ s e
grammar	g r a $ m a r
björsells	b j 9 $ " s` e l s
highland	h a j $ l a n d
rubricerat	r }: $ b r I $ " s e: $ r a t
opålitli	" " u: $ p O $ % l i: t $ l I
ferosjön	f e $ r U $ % x\ 9 n
analogt	a $ n a $ " l o: g t
pkbanken	p e: $ k o: $ " " b a N $ k e n
blomgren	" " b l U m $ % g r e: n
afghanbeluttj	a f $ " " g A: n $ b e $ " l u0 t $ j
församlingsexpeditionen	f 9 $ " " s` a m $ l I N s $ e k $ s p e $ d I $ % x\ u: $ n e n
ääah	E: a
heltidsfacklig	" " h e: l $ t i: d s $ % f a $ k l I g
ytteliare	" " Y $ t e $ l i: $ a $ r e
solskenssånger	" " s u: l $ x\ e: n s $ % s O N $ e r
eyes	e $ j e s
ickementalt	" " I $ k e $ m e n $ " t A: l t
vocabulary	v U $ " k a b }: $ l a $ r Y
distrikssköterskan	d I $ " s t r I k s $ % x\ 2: $ t e $ s` k a n
tvåhundring	t v o: $ h u0 n $ d r I N
kvalitetsplan	k v a $ l I $ " " t e: t s $ % p l A: n
answer	a n $ " s v e r
regulo	r e $ g u0 $ l U
manifesta	m a $ n I $ f e $ s t a
inbjuden	" " I n $ % b j }: $ d e n
jobbit	" " j O $ b I t
fönstematerial	" " f 9 n $ s t e $ m a $ t e $ r I $ % A: l
oxå	" " U k s $ % o:
spegelbyrå	" " s p e: $ g e l $ % b y: $ r o:
projektuppföljningssystem	p r U $ " " x\ e k t $ u0 p $ % f 9 l j $ n I N s $ s Y $ % s t e: m
sorgli	" " s O r j $ l I
glasögena	" " g l A: $ % s 2: $ g e $ n a
bråttomgrej	" b r O $ t O m $ g r e j
finaverken	f I $ n a $ % v e r $ k e n
fölora	" f 2: $ l o: $ r a
färdi	" " f E: $ d` I
mammarollen	" " m a $ m a $ % r O $ l e n
sekreterarskapen	s e $ k r e $ " " t e: $ r a $ % s` k A: $ p e n
hääh	" " h E:
kristallampa	k r I $ s t a $ % l a m $ p a
intresangt	I n $ t r e $ " s a N t
motsatte	" " m u: t $ % s a $ t e
rex	" " r e k s
djurungar	" " j }: r $ % u0 N $ a r
igenklien	I $ " " j e n $ % k l I $ e n
musikafton	m }: $ " " s i: k $ % a f $ t O n
epistemisk	e $ p I $ " s t e: $ m I s k
obetydli	" " u: $ b e $ % t y: d $ l I
oing	" " u: $ I N
facke	" f a $ k e
fictitious	" f I k $ s' " x\ u: s
away	" A: $ v e j
leand	l e $ " " a n d
heifetz	" h a j $ f e t s
esperanto-biblioteko	e $ s p e $ " " r a n $ t U $ b I $ b l I $ U $ % t e: $ k U
snuttan	" " s n u0 $ t a n
stockolm	" " s t O $ % k O l m
undeba	u0 n $ d e $ b a
liberalistiska	l I $ b e $ r a $ % l I $ s t I $ s k a
sues	" s u: s
sat	s a t
metskalor	" m e t $ s k A: $ l U r
ifrågasatte	I $ " " f r o: $ g a $ % s a $ t e
junior	j }: $ n I $ " o: r
horoskopo	h O $ r U $ " s k o: $ p U
arbet	" " a r $ b e: t
farebasisen	" f A: $ r e $ % b A: $ s I $ s e n
novar	" n u: $ v A: r
choice	" s' O j s
jajjemen	" j a j $ " j e: $ m e n
härborta	h E: r $ " " b O $ t` a
semjan	" " s e: $ m j a n
hämt	" " h e m t
trån	" " t r o: n
årning	o: $ n` I N
fee	" f i:
kontore	k O n $ " t u: $ r e
vrraha	" v r r A: $ h a
klinch	" k l I n` s`
upphetsad	" " u0 p $ % h e t $ s a d
socialantropologena	s U $ s I $ " " A: l $ a n $ t r U $ p U $ % l o: $ g e $ n a
likadanna	l i: $ k a $ " d a $ n a
vinlager	" " v i: n $ % l A: $ g e r
bladena	" b l A: $ d e $ n a
klippta	" " k l I p $ t a
komponentstyrningen	k O m $ p U $ " " n e n t $ % s t y: $ n` I N $ e n
mäte	" " m E: $ t e
konsultjobb	k O n $ " " s u0 l t $ % j O b
miljöfarli	m I l $ " " j 2: $ % f A: $ l` I
gölve	" " j 9 l $ v e
jump	" j u0 m p
knästrumper	" " k n E: $ % s t r u0 m $ p e r
svedjebränner	" " s v e: d $ j e $ % b r e $ n e r
piskad	" " p I $ s k a d
förorenad	" " f 2: r $ U $ % r e: $ n a d
försäljere	f 9 $ " s` e l $ j e $ r e
armeer	a r $ " " m e: $ e r
hannbagage	" h a n $ b a $ % g A: s`
konkurrensförutsättningarna	k O N $ k }: $ " " r a n s $ f 2: r $ }: t $ % s e t $ n I N $ a $ n` a
jämställda	" " j e m $ % s t e l $ d a
tätningsmedel	" " t E: t $ n I N s $ % m e: $ d e l
pomme	" p O $ m e
helpa	" " h e: l $ p a
likvärdia	" " l i: k $ % v E: $ d` I $ a
direktanslutning	d I $ " " r e k t $ a n $ % s l }: t $ n I N
keep	" k i: $ p
njäa	" n j E: $ a
kännts	" s' e n t s
uthyrningsfirmorna	" " }: t $ h y: $ n` I N s $ % f I r $ m U $ n` a
åv	o: v
kontaktvägarna	k O n $ " " t a k t $ % v E: $ g a $ n` a
tämjd	" " t e $ m j d
hmhm	" h u0 m m
biljäveln	" " b i: l $ % j E: $ v e l n
frågeområdena	" " f r o: $ g e $ O m $ % r o: $ d e $ n a
plena	" " p l e: $ n a
särskillt	" " s E: r $ % s` I l t
sverigekontakt	" " s v e r $ j e $ k O n $ % t a k t
wonderful	" v O n $ d e r $ f u0 l
reg	r e g
hundrafyrtiotvå	" " h u0 n $ d r a $ f 9 $ t` I $ U $ " t v o:
karhatare	" " k A: r $ % h A: $ t a $ r e
alfsen	" a l f $ s e n
sjäv	" " x\ E: v
okidokey	" " u: k $ I $ % d o: k Y
rakontoj	r a $ " " k O n $ t O j
åminstånne	" " o: $ m I $ % n I $ s t O $ n e
pidgin	" p i: d $ g I n
argumentum	a r $ g }: $ m e n $ t u0 m
non	n O n
faktoj	f a k $ t O j
pu	" p U
samhällsorganisation	" " s a m $ h e l s $ O r $ g a $ n I $ s a $ % x\ u: n
sassin	" s a $ " s i: n
brista	" " b r I $ s t a
biluthyrningsfirmor	" " b i: l $ }: t $ % h y: $ n` I N s $ % f I r $ m U r
naturtill	n a $ " " t }: $ t` I l
rise	" " r i: s
hundrafyrtionie	" " h u0 n $ d r a $ f 9 $ t` I $ U $ " " n i: $ e
påsgatan	" " p o: s $ % g A: $ t a n
verksamhetsspecifikt	" " v e r k $ s a m $ h e: t s $ s p e $ s I $ % f i: k t
besparingsprogrammet	b e $ " " s p A: $ r I N s $ p r U $ % g r a $ m e t
underhållsstatus	" " u0 n $ d e r $ h O l s $ % s t A: $ t u0 s
ifyllt	" " i: $ % f Y l t
corsetti	k O $ " s` e $ t I
logfil	" " l u: g $ % f i: l
musikredaktör	m }: $ " " s i: k $ r e $ d a k $ % t 2: r
fakturerna	f a k $ " t }: $ r e $ n` a
fixer	f I k $ " " s e: r
pattern	" p a $ t e n`
förvärvad	f 9 r $ " v e r $ v a d
blodtryckstabletter	" " b l u: d $ t r Y k s $ t a $ % b l e $ t e r
passe	" p a $ s e
oaggmunk	" " u: $ % a g $ % m u0 N k
diamantstygn	d i: $ a $ " " m a n t $ % s t Y N n
lejonkungsdressarna	" " l e $ j O N $ k u0 N s $ % d r e $ s a $ n` a
tiotusenlappar	" " t i: $ U $ t }: $ s e n $ % l a $ p a r
rr	" " e r $ e r
förrns	" f 9 n` s`
asfaltsvägar	" " a s $ f a l t s $ % v E: $ g a r
avloppsfrågan	" " A: v $ l O p s $ % f r o: $ g a n
avhärdningsfilter	" " A: v $ % h E: d` $ n` I N s $ % f I l $ t e r
tjip	" s' i: p
mblärenden	e m $ b e: $ " " e l $ % E: $ r e n $ d e n
pojktokig	" " p O j k $ % t u: $ k I g
jajjamänsan	" j A: $ j a $ % m e n $ s a n
sjösystem	" " x\ 2: $ s Y $ % s t e: m
räsercykel	" r e $ s e $ % s` Y $ k e l
schlut	" s` l` }: t
reaktorsäkerhetsutredningen	r e $ " " a k $ t U $ s` E: $ k e r $ h e: t s $ }: t $ % r e: d $ n I N $ e n
fuskbög	" " f u0 s k $ % b 2: g
forshed	" " f O s` $ % h e: d
penderecki	p e n $ " " d e: $ e $ k I
kvinnerna	" " k v I $ n e $ n` a
shots	" s' O t s
fågna	" " f o: $ g n a
fb	e f $ b e:
johanssvampar	" " j u: $ h a n s $ % s v a m $ p a r
available	a $ v a j $ l A: $ b l e
beredskapsarbetsplatser	b e $ " " r e: d $ s k A: p s $ a r $ b e: t s $ % p l a t $ s e r
interaktionell	I n $ t e $ r a k $ x\ U $ " n e l
bakhtiarimattan	" " b A: k $ t $ s I $ a $ r I $ % m a $ t a n
äf	E: v
resursnämndsutgifter	r e $ " " s u0 s` $ % n` e m n d s $ }: t $ % j I f $ t e r
cy	s Y
hälit	" h e $ l I t
tillägnande	" " t I l $ % e N $ n a n $ d e
rrrung	" " e r $ e r $ " r u0 N
syresnedsättande	" " s y: $ r e s $ n e: d $ % s e $ t a n $ d e
opererad	O $ p e $ " r e: $ r a d
kontrastiv	k O n $ t r a $ " s t i: v
tregrejen	" " t r e: $ % g r e $ j e n
klasgöran	" " k l A: s $ j 2: $ r a n
elskåpe	" " e: l $ % s k o: $ p e
vinne	" " v I $ n e
siktab	" " s I k $ t a b
fångstsamhället	" " f O N s t $ s a m $ % h e $ l e t
nönting	" n 9 n $ t I N
bokningsnummer	" " b u: $ k n I N s $ % n u0 $ m e r
malgranda	" " m A: l $ g r a n $ d a
teach	" " t i: s`
kärnkraftsdiskussionen	" " s' E: n` $ k r a f t s $ d I $ s k u0 $ % x\ u: $ n e n
invändigt	" " I n $ % v e n $ d I k t
östelandet	" 9 s t $ e $ % l a n d $ d e t
albumo	a l $ b }: $ m U
möjlihetena	" " m 9 j $ l I $ h e: $ t e $ n a
äve	" E: $ v e
cilia	" " s i: $ l I $ a
undeförstådda	" " u0 n $ d e $ f 9 $ % s` t` O $ d a
packad	" " p a $ k a d
ansetts	" " a n $ % s e t s
instutitionaliserar	" " I n $ s t }: $ t I t $ x\ U $ n a $ l I $ " s e: $ r a r
helenetorp	h e $ l e: $ n e $ " t O r p
mtd	e m $ t e: $ " d e:
felvara	" " f e: l $ % v A: $ r a
etthundrafemtiotusen	e t $ h u0 n $ d r a $ f e m $ t I $ U $ " t }: $ s e n
nightmare	" n i: g t $ m a $ r e
beeroende	" b i: $ r U $ e n $ d e
probl	p r U $ " b l
fyraåri	" " f y: $ r a $ % o: $ r I
undeställda	" " u0 n $ d e $ % s t e l $ d a
alon	a $ " l O n
than	" t a n
kvantifikator	k v a n $ t I $ f I $ " " k A: $ t U r
tjugien	" " s' }: $ g I $ e n
programstomme	p r U $ " " g r a m $ % s t U $ m e
reichenbachska	" r e j $ s' e n $ b a x\ s $ k a
cykeldemonstration	" " s Y $ k e l $ d e $ m O n $ s t r a $ % x\ u: n
skillnade	" " x\ I l $ n a $ d e
undebar	" " u0 n $ d e $ % b A: r
mammeluck	" " m a $ m e $ " l u0 k
pågatåg	" " p o: $ g a $ % t o: g
kattja	" " k a t $ j a
götaälv	" " j 2: $ t a $ % e l v
sjutisju	" " x\ }: $ t I $ " x\ }:
beluttj	b e $ " l u0 t $ j
sleten	" s l e: $ t e n
fak	f a k
yt	" " y: t
älfsjö	" e l f $ % x\ 2:
uttalad	" " }: t $ % t A: $ l a d
rakkräm	" " r A: k $ % k r E: m
hösthalkan	" " h 9 s t $ % h a l $ k a n
vejga	" " v e j $ g a
chessmaster	" s' e s $ % m a $ s t e r
rage	" r A: s`
möjligör	" " m 9 j $ l I k t $ % 2: r
danmarksbåten	" " d a n $ m a r k s $ % b o: $ t e n
saaba	" " s A: $ b a
mötesrum	" " m 2: $ t e s $ % r u0 m
tekno	t e $ k n U
kundlistan	" " k u0 n d $ % l I $ s t a n
zurich	" s u: $ r I k
träjdade	" " t r E: $ % j $ d a $ d e
uppvärmningsform	" " u0 p $ v e r m $ n I N s $ % f O r m
fritisverksamhet	" " f r i: $ t i: s $ v e r k $ s a m $ % h e: t
jar	" j a r
borjade	" b O r $ j a $ d e
återkallan	$ o: $ t e r $ % k a $ l a n
rotti	" " r O $ t I
lsg	" " e l $ e s $ % g e:
somebody	" s O $ m e $ b O $ d Y
sjuhundrasexti	x\ }: $ h u0 n $ d r a $ s e k $ s t I
gallerskål	" " g a $ l e $ % s` k o: l
kompany	k O m $ p a $ n Y
fyrahundratjufem	f y: $ r a $ h u0 n $ d r a $ s' }: $ " f e m
färge	" " f e r $ j e
sammankopplat	" " s a $ m a n $ % k O $ p l a t
hundranie	" " h u0 n $ d r a $ " " n i: $ e
prometeus	p r U $ m e $ " " t e: $ u0 s
viljer	" " v I l $ j e r
sammma	" s a $ m a
befattningstrygghet	b e $ " " f a t $ n I N s $ t r Y g $ % h e: t
någelunda	" " n o: $ g e $ % l u0 n $ d a
huu	" h u:
spegule	" " s p e: $ % g }: $ l e
sävenäs	" " s E: $ v e $ % n E: s
manipulerad	m a $ n I $ p }: $ " l e: $ r a d
hösttrött	" " h 9 s t $ % t r 9 t
lacklarebäck	l a $ " " k l A: $ r e $ % b e k
learned	" l i: $ n` e: d
nope	" n u: $ p e
couldnt	k U $ " l n t
kalkstensbrott	" " k a l k $ s t e: n s $ % b r O t
hannlar	" h a n $ l a r
oljeresurser	" " O l $ j e $ r e $ % s u0 $ s` e r
almhed	" " a l m $ % h e: d
kanos	k a $ " n u: s
parking	" " p A: r $ k I N
fyrahu	f y: $ r a $ h u0
nollsex	" " n O l $ % s e k s
förvissad	f 9 r $ " v I $ s a d
hannt	" h a n t
försår	f 9 $ " s` o: r
jättefräckt	" " j e $ t e $ % f r e k t
blodtryckstabletterna	" " b l u: d $ t r Y k s $ t a $ % b l e $ t e $ n` a
kattfarmare	" " k a t $ % f a r $ m a $ r e
kulturbegreppen	k u0 l $ " " t }: r $ b e $ % g r e $ p e n
idealspråks	I $ d e $ " " A: l $ % s p r o: k s
oanvänbart	" " u: $ a n $ v e n $ b A: t`
medorganism	" " m e: d $ O r $ g a $ % n I s m
medansvaria	" " m e: d $ a n $ % s v A: $ r I $ a
jätteont	" " j e $ t e $ % U n t
buffè	" " b u0 $ f e E:
barnskötersker	" " b A: n` $ % x\ 2: $ t e $ s` k e r
skötit	" " x\ 2: $ t I t
reavara	" " r e: $ a $ % v A: $ r a
förm	f 9 r $ " m e: $ t e r
programspråk	p r U $ " " g r a m $ % s p r o: k
vt	" f t
kuvertväskerna	k }: $ " " v E: r $ % v e $ s k e $ n` a
fårnte	" " f o: r $ n t
firmax	" " f I r $ m a k s
nittien	n I $ t I $ " e n
svarvat	" " s v a r $ v a t
diskussionspartner	d I $ s k u0 $ " " x\ u: n s $ % p A: t` $ n` e r
konsollbord	k O n $ " s O l $ % b u: d`
orginale	O r $ g I $ " n A: $ l e
beba	" b e: $ b a
fyndshopen	" f Y n d s $ % h u: $ p e n
flytte	" f l Y $ t e
activity	" a k $ t I v I $ t Y
buljongkoppar	b u0 l $ " " j O N $ % k O $ p a r
idastorp	" " i: $ d a s $ % t O r p
tevekändisen	" " t e: $ v e $ % s' e n $ d I $ s e n
torupsområdet	" t u: $ r u0 p s $ O m $ % r o: $ d e t
matterna	" " m a $ t e $ n` a
sidena	" " s i: $ d e $ % n a
kärnkraftsvalet	" " s' E: n` $ k r a f t s $ % v A: $ l e t
förrådsmästarn	f 9 r $ " " r o: d s $ % m e $ s t a n`
trodd	" t r U d
slumpmässi	" " s l u0 m p $ m e $ s I
bresnjev	" b r e s $ n j e v
turtlevax	" t u0 t` $ % l` e: $ v a k s
vargspråket	" " v a r j $ % s p r o: $ k e t
lämn	" " l e m n
barnstorlekar	" " b A: n` $ s` t` u: $ % l` e: $ k a r
trivselpengar	" " t r i: v $ s e l $ % p e N $ a r
dokumenterad	d O $ k }: $ m e n $ " t e: $ r a d
ååå	o: o:
twelve	" t v e l $ v e
smällt	" s m e l t
disclaimern	" d I s k l e j $ m e n`
värderande	v e $ " d` e: $ r a n $ d e
däckena	" d e $ k e $ n a
kårkrönika	" " k o: r $ % k r 2: $ n I $ k a
plåg	" " p l o: g
tol	" t u: l
paralelltext	p a $ r a $ " " l e l $ % t e k s t
sekreterar	s e $ k r e $ " " t e: $ r a r
utpekad	" " }: t $ % p e: $ k a d
transvistiter	t r a n $ s v I $ " s t i: $ t e r
åkså	o: k $ s O
beslutsläge	b e $ " " s l }: t s $ % l E: $ g e
förstekontorist	" " f 9 $ s` t` e $ k O n $ t U $ " r I s t
vänn	" " v e n
ungdomssak	" " u0 N $ d U m s $ % s A: k
behönte	b e $ " h 2: n $ t e
hundrafyra	" " h u0 n $ d r a $ " " f y: $ r a
historio	h I $ s t u: $ r I $ U
trehundrasjutti	t r e: $ h u0 n $ d r a $ " " x\ u0 $ t I
kommmer	k O $ " " m A: t $ m e r
förstöre	f 9 $ " s` t` 2: $ r e
pangkrock	" " p a N $ % k r O k
taxfreeshop	" " t a k s $ f r i: $ % x\ O p
näbbing	" " n e $ b I N
överlappningstaxer	$ 2: $ v e $ % l` a p $ n I N s $ t a k $ s e r
censurerat	s e n $ s }: $ % r e: $ r a t
stjärnerna	" " x\ E: n` $ e $ n` a
naprosyn	n a $ p r U $ % s y: n
jaamen	" j A: $ m e n
pluppar	" " p l u0 $ p a r
sjuhundring	x\ }: $ " h u0 n $ d r I N
hålogiken	" " h o: $ l U $ " g i: $ k e n
däre	" d E: $ r e
farebasis	" f A: $ r e $ % b A: $ s I s
mosad	" " m u: $ s a d
specialupphandla	s p e $ s I $ " " A: l $ u0 p $ % h a n d $ l a
grejora	" " g r e $ j U $ r a
sprängtekniker	" " s p r e N $ % t e $ k n I $ k e r
påstådda	" " p o: $ % s t O $ d a
apelsinsopp	a $ p e l $ " " s i: n $ % s O p
tjugesju	" " s' }: $ g e $ " x\ }:
logopedutbildning	l O $ g U $ " p e: d $ }: t $ % b I l d $ n I N
enkonduko	" " e: N $ k O n $ d }: $ k U
uppepå	" " u0 $ p e $ p o:
gabbehmatta	" g a $ b e x\ $ " m a $ t a
konstanthålla	k O n $ " " s t a n t $ % h O $ l a
altroistisk	a l $ t r U $ " I $ s t I s k
tevesiderna	" " t e: $ v e: $ % s i: $ d e $ n` a
kräker	" k r E: $ k e r
tolvtonsserie	" " t O l v $ t u: n s $ % s e: $ r I $ e
tch	" t s'
stånnpunkt	" s t O n $ % p u0 N k t
dröppa	" " d r 9 $ p a
johoho	" j O $ h O $ h O
försäkringsaktiebolag	f 9 $ " " s` E: $ k r I N s $ % a k t $ s I $ e $ b u: $ % l A: g
uppi	" " u0 $ p I
öve	" " 2: $ v e
taligan	t a $ l I $ " g A: n
frisktandvårdsprojektet	" " f r I s k $ " t a n d $ v o: d` s` $ p r U $ % x\ e k $ t e t
fylle	" " f Y $ l e
sykiskt	s Y $ k I s k t
rilate	r I $ " l A: $ t e
grö	" " g r 2:
yxi	" " Y k $ s I
direktflight	d I $ " " r e k t $ % f l a j t
tvåer	" " t v o: $ e r
lönsamhetsprincip	" " l 2: n $ s a m $ h e: t s $ p r I n $ % s i: p
jaeh	" j A:
kommunikationssätt	k O $ m }: $ n I $ k a $ " " x\ u: n s $ % s e t
sjuttfem	x\ u0 $ t I $ " f e m
evangelitexten	e $ v a $ n j e $ l I $ " t e k $ s t e n
däröppe	" d E: $ r 9 $ p e
didär	d I $ " d E: r
nääj	" n E: j
sexplosion	" " s e k $ s p l U $ % x\ u: n
rikkes	" " r I $ k e s
mikrointervall	" " m I $ k r U $ I n $ t e r $ % v a l
bohuslandstingets	" " b u: $ h }: s $ l a n d s $ % t I N $ e t s
betaler	b e $ " t A: $ l e r
ologist	" " u: $ l o: $ g I s t
centralmassiv	s e n $ " " t r A: l $ m a $ % s i: v
scoutöppnare	" " s k a*U t $ % 9 p $ n a $ r e
rydbergsgatan	r y: d $ b e r j s $ % g A: $ t a n
hamadan	" h a $ m a $ " d A: n
whow	" v O v
natvis	n a $ t v i: s
atomatist	a $ t U $ m a $ " t I s t
kortsikti	" " k O t` $ % s` I k $ t I
sine	" s I n
throat	" t r u: t
banane	b a $ " n A: $ n e
enklere	e N $ " k l e: $ r e
märkta	" " m e r k $ t a
bolage	b u: $ l A: $ g e
kupe	" " k }: $ p e
koppakälet	" " k O $ p a $ % s' E: $ l e t
30.0	" t r e: t u: $ r e n
sutti	" " s u0 $ t I
ret	" r e: t
prototypteorin	p r U $ t U $ " " t y: p $ t e: $ U $ % r i: n
switcha	" s v I t s' a
värmlan	" " v e r m $ l a n
kriteria	k r I $ " t e: $ r I $ a
åttahundratjufem	" " O $ t a $ h u0 n $ d r a $ s' }: $ " f e m
köksorganisationen	" " s' 9 k s $ O r $ g a $ n I $ s a $ % x\ u: $ n e n
carlbert	" " k A: l` $ b e t`
gaggi	" " g a $ g I
elbehovet	" " e l $ b e $ % h u: $ v e t
svalkande	" " s v a l $ k a n $ d e
earth	" 2: t`
barko	" " b a r $ k U
ottervik	" " U $ t e r $ % v i: k
städkostnaden	" " s t E: d $ % k O s t $ n a $ d e n
föratt	f 9 r $ " a t
baserad	b a $ " s e: $ r a d
kweida	" k v a j $ d a
tjugoetter	s' }: $ g U $ " e $ t e r
12.0	" e t s' }: $ g a $ r e n
prostiderad	p r O $ s t I $ % d e: $ r a d
vilseledandet	" " v I l $ s e $ % l e: $ d a n $ d e t
prototypiska	p r U $ t U $ " t y: $ p I $ s k a
revelutionär	r e $ v e $ l }: $ x\ U $ % n E: r
definitionsfråga	d e $ f I $ n I $ " " x\ u: n s $ % f r o: $ g a
majena	m a $ j e $ n a
potat	p O $ " t A: t
mäst	" " m e s t
underhållsskyldi	" " u0 n $ d e r $ h O l s $ x\ Y l $ d I
underhållsresurserna	" " u0 n $ d e r $ h O l s $ r e $ % s u0 $ s` e $ n` a
hundrafemtionie	" " h u0 n $ d r a $ f e m $ t I $ U $ " " n i: $ e
delrutiner	" " d e: l $ r }: $ % t i: $ n e r
ng	e n $ " g e:
månge	" " m O N $ e
clear	" " k l e: r
återbördad	$ o: $ t e r $ % b 2: $ d` a d
användingar	" " a n $ v e n $ d I N $ a r
nittonhundrasjutti	" " n I $ t O n $ h u0 n $ d r a $ " " x\ u0 $ t I
därmä	d e r $ m E
orginalo	O r $ g I $ " n A: $ l U
privativt	p r I $ v a $ " t i: f t
hökst	" h 2: k s t
femlånga	" " f e m $ % l O N $ a
fucking	" f u0 $ k I N
aktoj	" " a k t $ O j
hjälpta	" " j e l p $ t a
textiltryck	t e k s $ " " t i: l $ % t r Y k
motionskampen	m U t $ " " x\ u: n s $ % k a m $ p e n
ickenaturliga	" " I $ k e $ n a $ % t }: r $ l` I $ g a
miljöfack	m I l $ " " j 2: $ % f a k
utbrytelser	" " }: t $ % b r y: $ t e l $ s e r
traktamente	t r a k $ t a $ % m e n $ t e
dynamix	d Y $ n a $ " m I k s
femhålingen	f e m $ " h o: $ l I N $ e n
daxå	" " d a k s $ % o:
naturbalansen	n a $ " " t }: r $ b a $ % l a n $ s e n
trehåling	t r e: $ " h o: $ l I N
åttiåfem	" " O $ t I $ o: $ " f e m
övehuvetaget	" " 2: $ v e $ % h }: $ v e $ % t A: $ g e t
senere	s e $ n e $ r e
vdn	" " v e: $ d e: $ " e n
giftinformation	" " j I f t $ I n $ f O r $ m a $ % x\ u: n
vortaro	" v O $ t` a $ r O
sabene	s a $ " b e: $ n e
signalfunktion	s I N $ " " n A: l $ f u0 N k $ % x\ u: n
wunderlig	v e $ " u0 n $ d e $ l` I g
avslöjad	" " A: v $ % s l 9 $ j a d
barndresserna	" " b A: n` $ d` r e $ s e $ n` a
språkunskaper	" " s p r o: $ k u0 n $ % s k A: $ p e r
någeting	" " n o: $ % j e: $ t I N
virtuala	v I $ t` }: $ " A: $ l a
jättehårda	" " j e $ t e $ % h o: $ d` a
gabbehn	" g a $ b e: n
gubbera	" " g u0 b $ % e: $ r a
opåverkat	" " u: $ p o: $ % v e r $ k a t
onglund	O N $ % g l u0 n d
chimpanser	k I m $ " p a n $ s e r
sydda	" " s Y $ d a
vesste	" " v e $ s t e
härigebåj	" h E: r $ I $ j e: b O j
kommunkations	k O $ " " m }: n $ k a $ " x\ u: n s
skaderna	" " s k A: $ d e $ n` a
exprementell	e k $ " " s p r e $ m e n $ " t e l
prrr	p r r
falisius	f a $ l I $ s I $ u0 s
föfattarna	" " f 2: $ % f a $ t a $ n` a
eksterteranoj	" " e: k $ % s t e $ t` e $ a $ n O j
språkinlärnin	" " s p r o: k $ I n $ % l E: $ n` I n
sitationen	s I $ t a $ " x\ u: $ n e n
kontrollstruktur	k O n $ " " t r O l $ s t r u0 k $ % t }: r
maxpoäng	" " m a k s $ p U $ % e N
nämlien	" " n e m $ l i: $ e n
planlägger	" " p l A: n $ % l e $ g e r
fångstsamhälle	" " f O N s t $ s a m $ % h e $ l e
kovert	" " k u: $ v e t`
water	" v o: $ t e r
flagger	" f l a $ g e r
åtevända	o: t $ e $ % v e n $ d a
behållt	b e $ " h O l t
bärgningschef	" " b e r j $ n I N s $ % x\ e: f
mängdteoretiska	" " m e N d $ t e: $ U $ % r e: $ t I $ s k a
sciencaj	" s a $ j e n s a j
schar	" s` a r
språkkonsult	" " s p r o: k $ k O n $ % s u0 l t
fötroendet	" " f 2: $ % t r u: $ e n $ d e t
defi	d e $ f I
jätteläckra	" " j e $ t e $ % l e $ k r a
sempulu	" s e m $ p }: $ l }:
hundrasextioåtta	" " h u0 n $ d r a $ " " s e k $ s t I $ U $ " " O $ t a
dagverksamheterna	" " d A: g $ v e r k $ s a m $ % h e: $ t e $ n` a
träsaker	" " t r E: $ % s A: $ k e r
rundkaker	" " r u0 n d $ % k A: $ k e r
oppfattade	" " O p $ % f a $ t a $ d e
taxena	" " t a k $ s e $ n a
fritidsstugor	" " f r i: $ t i: d s $ % s t }: $ g U r
underli	" " u0 n $ d e $ l` i:
mammelucker	" " m a $ m e $ " l u0 $ k e r
tistrand	t I $ % s t r a n d
tumlarn	" " t u0 m $ l a n`
kallebäcks	" " k a $ l e $ b e k s
soffprogrammen	" " s O f $ p r U $ % g r a $ m e n
lot	" l U t
tillkonstlat	" " t I l $ % k O n s t $ l a t
off	" " O f
kurse	k u0 $ " s` e:
försvagad	f 9 $ " s` v A: $ g a d
tschy	" t x\ Y
tjugofemnollsju	s' }: $ g U $ f e m $ " n O l $ " x\ }:
marjasin	" m a r $ j a $ " s i: n
aimee	" a j $ m I
aaj	" " o: $ % j i:
vinterintressen	" " v I n $ t e r $ I n $ % t r e $ s e n
begreppsbild	b e $ " " g r e p s $ % b I l d
parantesen	p a $ r a n $ % t e: $ s e n
bapap	b a $ " " p a p
talakter	" " t A: l $ % a k $ t e r
ickenaturresurs	" " I $ k e $ n a $ " " t }: r $ r e $ % s u0 s`
reservda	r e $ " " s e r v $ d a
senfästet	" " s e: n $ % f e $ s t e t
höhö	" " h 2: $ % h 2:
ointuitiv	" " u: $ I n $ t }: $ I $ " t i: v
sät	" s E: t
vl	" v l
direktinblandade	d I $ " " r e k t $ I n $ % b l a n d $ d a $ d e
förståligt	f 9 $ " s` t` o: $ l I k t
ärendemängden	" E: $ r e n $ d e $ % m e N $ d e n
situationella	s I $ t }: $ a t $ x\ U $ % n e $ l a
mensan	m e n $ s a n
uhum	" u: u0 m
tajmat	" " t a j $ m a t
philips	" " f i: $ l I p s
säskild	s e $ " " s k I l d
prater	" p r A: $ t e r
svetsfelen	" " s v e t s $ % f e: $ l e n
mörrn	" m 9 n`
femtitvå	" " f e m $ t I $ % t v o:
kapitalmassa	k a $ p I $ " " t A: l $ % m a $ s a
instämme	" " I n $ s t e $ m e
hundratjusju	" " h u0 n $ d r a $ " " s' }: $ " x\ }:
språkvetenskapli	" " s p r o: k $ v e: $ t e n $ % s k A: $ p l I
punkta	p u0 N k $ t a
igebåj	" " i: $ g e $ b j
vae	" v e:
ofalit	" " u: $ f a $ " l i: t
ihå	I $ " " h o:
vågerna	" " v o: $ g e $ n` a
personalpolitiska	p e $ s` U $ " " n A: l $ p U $ % l i: $ t I $ s k a
attså	" " a t $ % s o:
häraldsson	" " h E: $ r a l d $ s O n
högtidligt	" " h 9 k $ % t i: d $ l I k t
sian	" " s i: $ a n
copy	" k O $ p I
utbilningar	" " }: t $ % b i: l $ n I N $ a r
telefonnummret	t e $ l e $ " " f o: n $ % n u0 m $ r e t
esperantoböcker	e $ s p e $ " " r a n $ t U $ % b 9 $ k e r
taxerad	t a k $ " s e: $ r a d
intervjuen	I n $ t e r $ " v j }: $ e n
lagts	" l a k t s
numrå	n u0 m $ " r o:
ngot	e N $ " g u: t
jättevackert	" " j e $ t e $ % v a $ k e t`
posomgrupperna	p U $ " s o: m $ % g r u0 $ p e $ n` a
fantastis	f a n $ t a $ " s t i: s
uppenbalien	" " u0 $ p e n $ b A: $ l I $ e n
grr	g e: $ e r $ " e r
involverad	I n $ v O l $ " v e: $ r a d
träbitana	" " t r E: $ % b i: $ t a $ n a
ihf	I $ " " h o: $ % e f
mee	" m e:
studentbiljetten	s t }: $ " " d e n t $ b I l $ % j e $ t e n
liberace	l I $ b e $ " r A: s
mittdörrar	" " m I t $ % d 9 $ r a r
brattön	" " b r a t $ % 2: n
tyckeru	" " t Y $ k e $ r }:
svikomigång	" " s v i: $ k O $ m I $ " g O N
passagerum	p a $ " " s A: s` $ % r u0 m
departure	d e $ " p A: t` $ j 9 r
aeterni	A: $ e: $ t e $ " n` i:
klassificerat	k l a $ s I $ f I $ " s e: $ r a t
tiny	" t I $ n Y
uppfå1ning	" " u0 p $ % f O t $ n I N
behind	b e $ " h I n d
korporera	k O r $ p U $ " r e: $ r a
utskickat	" " }: t $ % x\ I $ k a t
jourlista	" " x\ u: r $ % l` I $ s t a
skitmycket	" " x\ i: t $ % m Y $ k e t
utomjordist	" " }: $ t O m $ % j u: $ d` I s t
självupplevelse	" " x\ e l v $ u0 p $ % l e: $ v e l $ s e
taxichafför	" " t a k $ s I $ x\ a $ " f 2: r
desperanto	d e $ s p e $ " " r a n $ t U
ledningsfel	" " l e: d $ n I N s $ % f e: l
beställe	b e $ " s t e $ l e
things	" " t I N s
dessto	d e s $ t U
lesjör	l e: $ x\ 2: r
jävullusisk	" " j E: $ v u0 $ l }: $ s I s k
kokade	" " k u: $ k a $ d e
allgatan	" " a l $ % g A: $ t a n
mosters	" m U $ s t e s`
risås	" " r i: s $ o: s
sättes	" " s e $ t e s
metapredikat	m e $ t a $ p r e $ d I $ % k A: t
spikad	" " s p i: $ k a d
saw	" s o:
epistemiska	e $ p I $ " s t e: $ m I $ s k a
nötdjur	" " n 2: t $ % j }: r
bibelsällskapet	" " b i: $ b e l $ s e l $ % s k A: $ p e t
kommi	k O $ m I
skider	" " x\ i: $ d e r
övergångställe	$ 2: $ v e r $ % g O N $ % s t e $ l e
dammsugarmunstycken	" " d a m $ % s }: $ g a r $ m u0 n $ % s t Y $ k e n
kajbildena	k a j $ " b I l $ d e $ n a
fördelaktiga	" " f 2: $ d` e: l $ % a k $ t I $ g a
poznan	p O t $ s n a n
försvarsanställda	f 9 $ " " s` v A: s` $ a n $ % s t e l $ d a
some	" s O $ m e
trehundratjunie	t r e: $ h u0 n $ d r a $ s' }: $ n I
äeh	e
parkeringsplasser	p a r $ " " k e: $ r I N s $ % p l a $ s e r
detet	d e $ t e t
kötte	" s' 9 $ t e
kreditering	k r e $ d I $ " t e: $ r I N
gideoniterna	j i: $ d e $ O n i: $ t e $ n` a
datastopp	" " d A: $ t a $ % s t O p
terroris	t e $ r U $ " " r I s
arvodister	a r $ v U $ " d I $ s t e r
fordonskungörelsen	" " f u: $ d` u: n s $ k u0 $ % n j 2: $ r e l $ s e n
dehära	d e $ h E: $ r a
homoj	h U $ " m O j
natlitvis	" " n a t $ l I $ % t v i: s
såvikumigång	s o: $ " " v i: $ k u0 $ m I $ " g O N
språkena	" " s p r o: k $ e $ n a
positionsangivelse	p U $ s I $ " " x\ u: n s $ a $ % n j i: $ v e l $ s e
socialutvecklingen	s U $ s I $ " " A: l $ }: t $ % v e $ k l I N $ e n
matematika	m a $ t e $ " m A: $ t I $ k a
likso	" " l i: k $ s U
ome	U $ m e
artificial	a $ t` I $ f I $ s I $ " A: l
avslutningsfråga	" " A: v $ s l }: t $ n I N s $ % f r o: $ g a
sesdekminuta	" s e s $ d e: k $ m I $ n }: $ t a
femhu	f e m $ " h }:
ritningsläsning	" " r i: t $ n I N s $ % l E: $ s n I N
nödv	" " n 2: $ d v
intresseflagga	I n $ " " t r e $ s e $ f l a $ g a
åttahund	" " O $ t a $ % h u0 n d
ämnesomsättningsprover	$ e m $ n e s $ O m $ % s e t $ n I N s $ % p r u: $ v e r
glasögona	" " g l A: s $ % 2: $ g U $ n a
harlow	h a r $ " l` O v
gallerimatta	g a $ l e $ " " r i: $ % m a $ t a
kalsta	" " k a l $ s t a
barntröjor	" " b A: n` $ % t` r 9 $ j U r
tweede	" t v i: $ d e
portugesa	p O $ t` }: $ " g e: $ s a
why	" v Y
jättekap	" " j e $ t e $ % k a p
kumigunganopp	" k }: $ m I $ " g u0 N $ g a $ n O p
karlix	" " k A: $ % $ l I k s
freej	f r e $ " e j
samtlia	" " s a m t $ l I $ a
kvalitè	k v a $ l I $ " " t E:
femtakt	" " f e m $ % t a k t
gödseln	" " g 9 t $ s e l n
any	a $ n Y
whos	v e $ h O $ " u: s
rassen	" r a $ s e n
spårvangn	" " s p o: r $ % v a N $ n
arizono	a $ r I $ " s o: $ n U
tecknad	" " t e $ k n a d
fötjänat	" " f 2: $ % s' E: $ n a t
frågen	" " f r o: $ g e n
åtminst	o: t $ m I n s t
räknemässigt	" " r E: $ k n e $ % m e $ s I k t
kråkebär	" " k r o: $ k e $ b E: r
procedurelle	p r U $ s e $ " d }: $ r e $ l e
svetsern	" s v e t $ s e n`
göteborgskort	j 2: $ t e $ " b O $ s` k U t`
tiningen	" " t i: $ n I N $ e n
jättedåliga	" " j e $ t e $ % d o: $ l I $ g a
quiet	" " k v i: $ e t
lämm	" " l e $ m
utställda	" " }: t $ % s t e l $ d a
tp	" " t e: $ % p e:
engångseffekt	" " e: N $ g O N s $ e $ % f e k t
motexempel	" " m u: t $ e k $ % s e m $ p e l
platåvakt	p l a $ " " t o: $ % v a k t
akvariet	a $ " " k v A: $ r I $ e t
handikapplägenheterna	" " h a n $ d I $ k a p $ l E: $ g e n $ % h e: $ t e $ n` a
gang	g a N
mariahår	m a $ " " r i: $ a $ % h o: r
doctor	" d O k $ t U r
mjä	" " m j E:
körd	" s' 2: d`
beautiful	b O $ t I $ " f }: l
faaen	" f e j a $ e n
landalaskolan	" " l a n $ d A: $ l a $ % s k u: $ l a n
romatic	r O $ " m A: $ t I t s'
veckerna	" " v e $ k e $ n` a
primativt	p r I $ m a $ " t i: f t
skuldförhållande	" " s k u0 l d $ f 9 r $ % h O $ l a n d $ d e
tillsattes	" " t I l $ % s a $ t e s
samtidit	" " s a m $ t i: $ d I t
smärglat	" " s m e r j $ l a t
gert-ove	j e t` $ " " u: $ v e
lördagmornar	" " l 2: $ d` A: g s $ % m o: $ n` a r
jupp	" j u0 p
metonymer	m e $ t U $ " n y: $ m e r
oljerummet	" " O l $ j e $ % r u0 $ m e t
nådd	" n O d
högpris	" " h 2: g $ p r i: s
szerdahelyis	s` e $ % d` A: l a j $ % i: s
dövspråk	" " d 2: v $ % s p r o: k
allmängilti	" " a l $ m e n $ % j I l $ t I
meibo	" m e j $ b U
bevilj	b e $ " v I l j
rmi	e r $ m I
pickles	" p I $ k l e s
proteintabletter	p r U $ t e $ " " i: n $ t a $ % b l e $ t e r
olovlit	" " u: $ % l o: v $ l I t
bortemot	" b O $ t` e $ m u: t
nestlè	n e s t $ " l e:
resumè	r e $ s }: $ " m E:
faridè	f a $ " r I d $ " e:
sü	s Y
què	" k v E:
idèsidan	" " I $ E: $ % s i: $ d a n
mülher	" m y: l $ h e r
lügor	" " l y: $ g U r
á	a
dü	" d Y
enbäddskupè	" " e: n $ b e t $ s k }: $ " e:
nestègodis	n e s t $ " E: $ % g u: $ d I s
hát	h a t
frün	f r y: n
lützens	" l Y t $ s e n s
schüller	" s` Y $ l e r
chèvren	" s' E: v r e n
