den	d e n
dä	" d E:
på	" p o:
där	d E: r
hä	" " h E:
hmm	h m
haa	" h A:
sån	" s o: n
fåx	" f O k s
som	" " s O m
hn	" " h o: $ % e n
dää	" d E:
hax	h a k s
av	" " A: v
mommo	m U $ m U
nn	" " e n $ e n
hnn	h o: $ e n $ " e n
nte	e n $ t e
ma	m a
baa	" b A:
få	" f o:
komme	k O $ m e
öö	2:
ill	" " I l
daa	" d A:
många	m O N $ a
äte	" E: $ t e
åsså	O $ s O
ba	b a
eh	" " e: $ % h o:
gåx	" " g O k s
ke	" k e
än	" e n
ga	" g a
sitte	" s I t
såå	" s o:
äm	e m
mn	" e m $ e n
ligge	" " l I $ g e
nääj	" n E: j
hää	" " h E:
detta	d e $ t a
itte	" I t
vaffö	v a $ " f $ 2:
bått	" " b O t
miin	m I $ I n
brm	b e: $ e r $ " e m
ramlax	" " r a m $ l a k s
mää	" m E:
såx	" s O k s
mer	" m e: r
mea	m e $ " A:
höö	" h 2:
luktax	" " l u0 k t $ % a k s
hästa	" " h e $ s t a
hittax	" " h I $ % t a k s
tatt	t a t
je	" j e
domma	d U $ m a
dicka	" " d I $ k a
näej	" " n E: $ e j
chitta	" s' I $ t a
tj	s'
domme	d U $ m e
das	" d a s
måsse	" " m O $ s e
gamma	" " g a $ m a
bort	" " b O t`
sä	" s E:
kå	" k o:
bra	" " b r a
bå	" b o:
vicken	" " v I $ k e n
gocka	" g O $ k a
che	s`
nagn	" n a N n
göa	" " j 2: $ a
kanse	" k a n $ s e
öppa	9 $ p a
häppa	" h e $ p a
tolla	" " t O $ l a
gä	" g E:
sätte	" " s e $ t e
bix	" b I k s
vafför	" v a $ " f 2: r
nam	" " n a m
gacka	" " g a $ k a
mammaa	m a $ " m A:
es	" e s
li	" l i:
lägge	" l e $ g e
tåx	" " t O k s
hoppax	" " h O p $ % a k s
naa	" n A:
mee	" m e:
nagna	" n A: $ g n a
ble	b l e
ji	" j I
sett	" s e t
gi	" g I
ähm	E: m
dee	" d i:
jå	" j O
farlit	" " f A: r $ % l` i: t
häs	" " h e s
riktit	" " r I k $ t I t
bumma	" b u0 $ m a
ao	a*U
mnä	m n E:
ådi	" " o: $ d I
gjode	" j u: $ d e
åå	o:
faktist	f a k $ " t I s t
trakton	t r a k $ " t o: n
mäs	" " m e s
hålle	" " h O $ l e
kunne	" " k u0 $ n e
badax	" " b A: d $ % a k s
tjå	" s' o:
leke	" " l e: $ k e
säje	" s e $ j e
haan	" h A: n
tså	" t s o:
jä	" j E:
ståx	" s t O k s
mam	m a m
ingeting	" " I n $ % j e: $ t I N
tappax	" " t a p $ % a k s
däs	" d E: s
räddis	" " r e d $ % i: s
lamlax	" " l A: m $ % l a k s
tittax	" " t I $ t a k s
väldit	" " v E: l $ d I t
boppa	" " b O $ p a
efter	" " e f $ t e r
ete	" e: $ t e
åsjå	o: $ x\ o:
thick	" " t I k
bosta	" b O $ s t a
jaj	" j a j
batten	" b a $ t e n
barbihästana	b a r $ b I $ " h e $ s t a $ n a
båtta	" " b o: t $ % t A:
mmm	e m $ e m $ " e m
dokton	" d O k $ t O n
ts	t s
had	" h a d
mölk	" " m 9 l k
bilana	" " b i: l $ a $ n a
lä	" l E:
kä	" k E:
åx	O k s
jaå	" " j A: $ % o:
fam	" " f a m
dään	" d E:
abbi	" a $ b I
jåo	" j O U
nin	" n i: n
neej	" n j e j
ähä	e $ h E
sut	" s }: t
mhm	m m
sönde	" " s 9 n $ d e
häm	" " h e m
tåå	" t o:
pumma	" p u0 $ m a
plass	" " p l a s
pinga	" p I N $ a
nang	" n a N
bile	" b i: $ l e
dat	" d a t
juffe	" j u0 $ f e
tamma	" t a $ m a
nåna	" " n o: $ n a
rammax	" " r a $ m a k s
åch	O s`
tä	t E
räcebil	r e $ " " s e: $ % b i: l
lick	" l I k
simmax	" " s I $ m a k s
däj	" d e j
gåffi	g U $ f I
ee	" e:
jilla	" j I $ l a
rär	" r E: r
bannbil	" " b a n $ % b i: l
anra	" " a n $ r a
bodet	" " b u: $ d e t
hit	" h I t
sch	" s`
häh	" " h E:
häj	" h e j
startsprer	" " s t A: t` $ % s` p r e r
gis	" g I s
denga	" d e N $ a
nö	" n 9
tha	" t a
su	" s }:
åss	O s
någon	" " n o: $ g O n
hunnen	" " h u0 $ n e n
biil	" " b i: $ % i: l
bäbi	" b E: $ b I
häd	" " h E: d
katte	" " k a $ t e
elle	" " e $ l e
nän	" " n e n
öpp	% 9 p
målax	" " m o: $ l a k s
nagne	" n A: $ g n e
dacka	" " d a $ k a
kötha	" " k 2: $ t a
härman	" " h e r $ m a n
sta	" " s t a
gaa	" g A:
håx	h O k s
fi	" f I
daj	" " d a j
dju	" " j }:
hått	h O t
bäbä	" b E: $ b E:
essa	" e $ s a
tjån	" s' o: n
tenna	t e $ n a
lamla	" " l A: m $ l a
famme	" " f a $ m e
mne	e m $ n e
ässa	e $ s a
hånn	h O n
dobbi	" " d O $ b I
bakom	" " b A: $ k O m
deen	" d i: n
roli	" " r u: $ l I
hee	" " h e:
pinge	" " p I N $ e
jammax	" " j a $ m a k s
hämtax	" " h e m $ t a k s
häppax	" h e $ p a k s
sove	" " s o: $ v e
ite	I $ t e
vatt	" v a t
maat	" m A: t
gjot	" j u: t
såån	" s o: n
boste	" " b u: $ s t e
äch	s`
däär	d E: r
änna	e $ n a
tjång	" s' O N
springe	" " s p r I N $ e
offa	O $ f a
maa	" m A:
socke	" " s U $ k e
daas	" d A: s
itat	" i: $ t a t
näh	" " n E:
hunde	" h u0 n $ d e
gla	" " g l a
hälle	" " h e $ l e
inna	I $ n a
hääst	" " h E: s t
nnä	" n E:
ech	" e x\
springde	" " s p r I N $ d e
kopa	" " k u: $ p a
kåcka	" k O $ k a
chå	" " s e: $ % h o:
såa	" " s o: $ a
jåå	" j o:
thä	" " t E:
ng	e n $ " g e:
ibland	" " i: $ b l a n d
lagax	" " l A: g $ % a k s
gäs	" j e s
fölla	" " f 9 $ l a
saps	" s a p s
köttbulla	" " s' 9 t $ % b u0 $ l a
gopa	" " g u: $ p a
däe	" " d E: $ e
it	" i: t
dei	" d e j
lalle	" " l a $ l e
kåckå	" k O k o:
festis	f e $ " s t i: s
fädit	" " f E: $ d I t
morfa	" m O r $ f a
hathe	" h A: $ t e
äd	" E: d
gecka	" g e $ k a
lå	" l o:
färge	" " f e r $ j e
tin	" t i: n
äj	e j
lassile	" l a $ s I $ l e
hästana	" " h e s t $ % A: $ n a
huja	h u0 $ j a
honnen	h O $ " n e n
nue	" n u:
jao	" j a*U
jeja	j e $ j a
hjäppa	" " j e $ p a
kill	" " k I l
gåo	g o: $ " u:
ruschkana	" r u0 s` $ % k A: $ n a
mök	" m 2: k
honne	h O $ " n e
apekalle	" " A: $ p e $ % k a $ l e
näjä	" n e j E
tol	" t u: l
genna	x\ e $ n a
puttax	" " p u0 $ t a k s
aå	" " A: $ % o:
duu	" d u:
kycke	" " k Y $ k e
öä	9 E
momo	m U $ m U
startsprej	" " s t A: t` $ % s` p r e j
gössel	" " j 9 $ s e l
tätta	" " t e $ t a
lammax	" " l a m $ % a k s
hänne	" h e $ n e
nine	n I n
aä	a E
motoren	m U $ " t u: $ r e n
tvättax	" " t v e $ t a k s
oppa	O $ p a
fylle	" " f Y $ l e
tompe	" " t U m $ p e
atta	" " a $ t a
däför	" " d E: $ % f 2: r
dät	" d E: t
hånnen	h O $ n e n
rolit	r U $ " l i: t
håt	" h o: t
nuja	n u0 $ j a
cyke	" " s Y $ k e
nite	" " n i: $ t e
jej	" j e j
tjusi	" " s' }: $ s I
vicket	" " v I $ k e t
sicka	" " s I $ k a
bankax	" " b a N k $ % a k s
ra	" r a
mii	m I $ " i:
ich	I t s'
nt	n t
tort	t U $ " " t`
häste	" h e $ s t e
ehm	" e: m
haam	" h A: m
tola	t O $ l a
jipen	" j i: $ p e n
moffa	" m O $ f a
patax	p a $ " t a k s
tetta	" t e $ t a
gådis	" " g o: $ d I s
stot	" " s t o: t
toki	" " t u: $ k I
tomtelisa	" " t O m $ t e $ % l i: $ s a
bilde	" " b I l $ d e
datta	" d a $ t a
kaste	" " k a $ s t e
smögås	" s m 2: $ g o: s
skojit	" " s k O $ j I t
krontobil	" " k r u: n $ t O $ % b i: l
jip	" j I p
hoppl	" " h O $ p e l
hähä	h e $ h E
föttena	" f 9 $ t e $ n a
däl	" d E: l
tsån	" t s o: n
sinna	" " s I $ n a
bum	" b u0 m
thet	" " t e: t
dåå	" d o:
tatta	" " t a $ t a
tanborst	t a n $ % b O s` t`
hässa	h e $ s a
tanna	" " t a $ n a
öppnax	% 9 p $ n a k s
fammo	" " f a $ m U
barbihästa	b a r $ b I $ " h e $ s t a
gikas	j I $ k a s
snat	" s n a t
buppa	" b u0 $ p a
blång	" " b l O N
icka	I $ k a
hamma	h a $ m a
tebaka	t e $ " b A: $ k a
taa	" t A:
morro	" " m O $ r O
babi	" b e j $ b I
chitte	" s' I t
bytt	" b Y t
jåmme	" j O $ m e
farli	" " f A: r $ % l` i:
kee	" k i:
jamlax	" j a m $ l a k s
åj	O j
fott	f O t
hänge	" " h e N $ e
bine	" " b i: $ n e
näa	" " n E: $ a
pappaa	" " p a $ p a $ % A:
ninnaa	" " n I $ n a
gäka	" j E: $ k a
saans	" s A: n s
keket	" " s' e: $ k e t
ita	" i: $ t a
titte	" t I t
trox	" " t r O k s
fabo	" " f A: $ b U
unde	u0 n $ d e
naä	" n e E
äi	e j
thunt	" t }: n t
kack	k a k
itta	" I $ t a
hät	" " h e t
alldes	a l $ d e s
pu	" p U
lja	e l $ j a
öve	" " 2: $ v e
nuv	" n }: v
bäggi	" " b e $ g I
söst	" s 2: s t
höne	" " h 2: $ n e
nen	n e n
stoppax	" " s t O p $ % a k s
pissån	" " p I s $ % o: n
prm	" " p e: $ e r $ " e m
kicke	" k I $ k e
hönana	" " h 2: $ % n A: $ n a
gang	g a N
ditta	" d I $ t a
vatha	v a $ t a
gex	" g e k s
öj	9 j
tåka	" " t o: $ k a
rosi	r U $ " s i:
srå	s r o:
höver	" " h 2: $ v e r
åttinie	" " O $ t I $ n I
chäje	x\ e $ j e
bab	" b a b
pelax	p e $ " l a k s
påå	" p o:
sält	" s E: l t
gn	" g n
nagnana	" " n a $ n j a $ n a
kaatt	" k A: $ t
svatt	" s v a t
påt	" p o: t
nähähä	n e $ h e $ h E
ahm	" " A: m
äp	E: p
vågax	" " v o: g $ % a k s
uppa	" " u0 p $ p a
barbihäst	b a r $ b I $ % h e s t
chuk	" s' U k
äa	" E: $ a
allti	a l $ t I
söra	" " s 2: $ r a
tommer	" t O $ m e r
des	" d e s
kåckax	" k O k s $ % a k s
butte	" b a $ t e
bostax	" " b u: $ % s t a k s
tit	" t I t
mölken	" m 9 l $ k e n
åd	o: d
baggi	" b a $ g I
mattå	" " m a t $ % t o:
bebi	" b E: $ b I
bosten	" " b u: $ % s t e: n
gisen	" g i: $ s e n
rä	" r E:
börjax	" " b 9 r $ j a k s
andreas	a n $ " " d r e: $ a s
dicke	" d I $ k e
höve	" " h 2: $ v e
kåninen	" " k O $ n I $ n e n
båte	" b o: $ t e
fatt	" f a t
sparkax	" " s p A: r $ % k a k s
nh	" n
brmma	b r $ m a
ii	i: $ i:
aaa	" " o: $ a
barbi	" b A: r $ b I
sika	" " s i: $ k a
jumpan	" " j u0 m $ p a n
filmölk	" " f I l m $ 9 l k
allahop	" " a $ l a $ % h u: p
jötha	" " j 2: $ t a
ns	n s
tjuffa	s' u0 $ f a
sit	" s I t
takton	" " t A: k $ % t u: n
bläss	" " b l e s
häpax	" " h E: p $ % a k s
gattar	" g a $ t a r
tän	" t E: n
chönne	x\ 9 $ n e
vaa	" v A:
stort	" " s t u: t`
fölis	f 9 $ " l i: s
munitollet	m }: $ n I $ t O $ l e t
tjuffe	s' u0 $ f e
kånin	" " k O $ n I n
vå	" v o:
jam	" j a m
tole	t O $ l e
tumpa	" " t u0 m $ p a
hea	" h e:
ropax	" " r u: p $ % a k s
fären	" " f E: $ r e n
ndä	n E
chut	" " x\ u0 t
konstit	k O n $ " s t i: t
blevlåstan	" b l e: v $ % l o: $ s t a n
dåx	" " d O k s
smojs	" s m O j s
nehä	n e $ h E
nuu	" n u:
eta	" e: $ t a
pringe	p r I N $ e
gogo	" " g u: $ g U
häja	h e $ j a
jum	" j u0 m
döt	" " d 9 t
dåcka	" " d O $ k a
sölla	" s 9 $ l a
vart	v a t`
ahä	" A: $ h E
prmma	p r $ m a
hushuset	" " h }: s $ % h }: $ s e t
häe	" " h E: $ e
tösti	" t 2: $ s t I
byxer	" " b Y k $ s e r
glä	" " g l E:
åssa	O $ s a
hae	" h e
kiver	" s' i: $ v e r
dats	" d a t s
jö	" " j 2:
kaker	" " k A: $ k e r
gubb	" " g u0 b
sapa	" s A: $ p a
däk	" d E: k
båppa	" " b O $ p a
neä	" n j E
gockaa	" g O $ " k A:
goka	" " g u: $ k a
sart	" " e s $ % A: t`
conela	k O N $ " " e: $ l a
däta	" " d E: $ t a
fypan	" " f y: $ p a n
bukax	" " b }: k $ % a k s
höck	" h 9 k
häth	" " h e t
mofas	m U $ f a s
åchå	O s` o:
farmo	" " f a r $ % m u:
mattin	m a $ " " t i: n
äää	E: E
näää	" n E: E
bebe	" b E: $ b e
åff	O f
snurrax	" " s n u0 $ r a k s
ika	" i: $ k a
tox	t O k s
kastax	k a $ " s t a k s
take	" t A: $ k e
hnä	h n E:
famo	f a $ m U
tänke	" " t e N $ k e
parkax	" " p a r k $ % a k s
mäj	" m e j
ae	e
höt	" h 2: t
jen	" j e n
hehe	h e $ h e
påx	" " p O k s
kikseånkinke	" " k I s $ o: N $ k I N $ k e
jons	" j u: n s
kittax	" " s' I $ t a k s
saaps	" s A: $ p s
dång	" " d O N
det	d e t
gäkippa	" g e $ k I $ p a
faktis	" f a k $ t I s
äppa	e $ p a
högt	" " h 9 k t
thlicka	t $ s l I $ k a
ride	" " r i: $ d e
brukax	" " b r }: k $ % a k s
höde	" " h 2: $ d e
blädda	" " b l e $ d a
våx	" " v O k s
deä	d e $ " E:
ette	" " e $ t e
stä	" s t E
smulton	" " s m u0 l $ t O n
låla	" " l o: $ l a
dla	d e $ s l a
seck	" s e k
fitt	" " f I t
tåffe	" " t O $ f e
hemmadal	" " h e $ m a $ % d A: l
th	t
hungi	" " h u0 N $ g I
thö	t 9
lämmax	" " l e $ m a k s
tompis	t O m $ " p i: s
vinnit	" " v I $ n I t
pringa	p r I N $ a
blomme	b l U $ m e
båcka	" " b O $ k a
läggde	" " l e g $ d e
ditte	" " d I $ t e
thej	t e j
olra	" O l $ r a
mine	" m i: n
dotto	" " d O $ t U
gåcka	" " g O k $ a
båssa	" " b O $ s a
måss	" " m O s
köö	" s' 2:
lejonkungen	" " l e $ j O n $ % k u0 N $ e n
packax	" " p a k $ % a k s
kompisa	" k O m $ p I $ s a
amla	a m $ l a
bäss	" b e s
thi	" " t I
tsen	" " t s e n
ått	O t
tjånn	" s' O n
kissax	" " k I $ s a k s
fyga	" " f y: $ g a
jida	" j i: $ d a
säj	" s e j
ätta	e $ t a
dinna	" d I $ n a
lullax	" " l u0 $ l a k s
jija	" j i: $ j a
ålla	O $ l a
momor	m U $ " m o: r
tjåja	" s' o: $ j a
plockax	" " p l O k $ % a k s
tåta	" " t o: $ t a
baak	" b A: k
dack	" d a k
chlut	k l }: t
gee	" j e:
falit	f a $ " l i: t
ocks	" O k s
åna	" " o: $ n a
meee	" m e:
haddax	h a $ " d a k s
sulle	" s a $ l e
lyffa	" l Y $ f a
däre	" d E: $ r e
tittä	" " t I $ t E
thätteto	t e: $ h e $ t e $ t O
flusvampen	f l }: $ % s v a m $ p e n
ääm	E: m
bite	" " b i: $ t e
däd	" d E: d
unnax	" " u0 $ n a k s
någe	" " n o: $ g e
vläss	" v l e s
ocksjå	" O k $ x\ o:
nat	" n A: t
haä	" h e E
måx	" " m O k s
frit	" f r I t
pekä	" " p e: k $ % E:
kanine	k a $ " " n i: n
dockena	" " d O $ k e $ n a
föliset	f 9 $ " l i: $ s e t
tråkit	" " t r o: $ k I t
åa	" " o: $ a
dääj	" d E: j
ämn	e m n
nänd	" " n e n d
äste	E: $ s t e
sat	s a t
uppä	" " u0 p $ % E:
jättemycke	" " j e $ t e $ % m Y $ k e
däa	" " d E: $ a
naj	" " n a j
honna	" h O $ n a
syka	s Y $ k a
acka	a $ k a
häsa	" " h E: $ s a
gle	" g l e
göbbe	" " j 9 $ b e
jattnet	" j a t $ n e t
heck	" h e k
kammax	" " k a $ m a k s
traktån	t r a k $ " t o: n
sn	" s n
chätta	" " s e: $ % h e $ t a
abba	a $ b a
läpa	" " l E: $ p a
sävl	" s e v l
pille	" p I $ l e
oll	O l
flugsvampana	" " f l }: g $ % s v a m $ p a $ n a
vappet	" v a $ p e t
mh	m
åck	O k
flickena	" " f l I $ k e $ n a
matax	" " m A: t $ % a k s
smussi	" s m u0 $ s I
jåm	" j O m
dodis	d U $ " d i: s
efte	" " e f $ t e
gää	" j E:
gu	" g }:
konsti	" " k O n $ s t I
mt	m t
mönk	" m 9 N k
pring	p r I N
toffe	" " t O $ f e
båcken	" " b O $ k e n
äcklit	e $ k l I t
jåhå	" j o: $ " h o:
tst	t s t
ähn	E: n
keas	" k e: $ a s
yss	" " Y s
chetta	x\ e $ t a
pela	" " p e: $ l a
tändena	" " t e n $ d e $ n a
klat	" k l a t
masin	m a $ " s i: n
pä	" p E:
pera	" p e: $ r a
gottkärra	" " g O t $ % s' e $ r a
tenga	" " t e N $ a
mäd	" m E: d
gåbben	" g O $ b e n
dobbe	" d O $ b e
änä	" e n E:
båtä	" " b o: t $ % E:
regnjacka	" " r e N n $ % j a $ k a
bambil	b a m $ " b i: l
fabon	f a $ b O n
tyss	" " t Y s
lädd	" l e d
negnax	" n e: $ g n a k s
trakto	" " t r a k $ t U
kladdi	" " k l a $ d I
kje	" " s' e
niin	" " n i: $ n
blommer	b l U $ m e r
mommos	m U $ % m u: s
thån	" " t o: n
midda	" m I $ d a
bäda	" " b E: $ d a
svå	" s v o:
gecke	" g e $ k e
oaoa	u: $ A: $ " u: $ a
äti	" E: $ t I
thyrka	t Y r $ k a
nagnen	" " n a $ n j e n
ooo	" o:
nejä	" " n e $ j E
ådå	" " o: $ d O
ehe	e $ h e
prästa	" " p r e $ s t a
njaa	" n j A:
bakax	" " b A: k $ % a k s
letax	l e $ " t a k s
blommena	b l U $ " m e: $ n a
herma	" " h e r $ m a
dägu	" " d e g }:
smutsi	" " s m u0 t $ s I
nehää	n e $ " h E:
dasi	" " d a $ s I
plåste	" " p l O $ s t e
siskar	" " s I $ s k a r
hittla	" h I t $ l a
ninne	" " n I $ n e
lamlade	" " l a m $ l a $ d e
hanla	" " h A: n $ l a
jipe	" j i: $ p e
ru	r U
äja	e $ j a
hön	" " h 2: n
aam	" a m
sna	" s n a
äl	E: l
nd	n d
tjova	" s' o: $ v a
barbidocka	" b A: r $ b I $ % d O $ k a
några	" " n o: $ r a
fåtta	" f O $ t a
mormo	" " m U r $ m U
läppa	" " l e $ p a
kånine	" " k O $ n I n
tsasi	" " t s A: $ s I
skrumejs	" s k r u0 $ m e j s
thöja	t 9 $ j a
blommerna	b l U $ m e $ n` a
sunga	" " s u0 N $ a
tänga	" " t e N $ a
dått	" " d O t
koko	" k U $ k U
bärde	" " b E: $ d` e
sälv	" s e l v
äckli	e $ " k l i:
kch	" " s' i: $ l U $ k
tante	" " t a n $ t e
vat	" v A: t
mjaa	" m j A:
pla	" " p l a
lisabet	" " l i: $ s a $ b e t
gao	" g a*U
chilla	" s' I $ l a
lette	" l e t
deej	d e $ " " e j
uta	" }: $ t a
tsåå	" t s o:
atten	a $ t e n
docke	" " d O $ k e
färdi	" " f E: $ d` I
säs	" s E: s
häxena	h e k $ s e $ n a
klippe	" k l I $ p e
böcke	" b 9 $ k e
tanborste	t a n $ % b O $ s` t` e
issa	" I $ s a
hunge	" " h u0 N $ e
petax	p e $ " t a k s
båckax	" " b O k s $ % a k s
åffa	O $ f a
dåli	" " d o: $ l I
sågel	" s o: $ g e l
gåka	" " g o: $ k a
däå	" d e o:
ea	" " e: $ % A:
tissa	" " t I $ s a
momma	m U $ m a
vo	" v O
allahopa	a $ l a $ " h u: $ p a
spelax	" " s p e: l $ % a k s
lånax	" " l o: n $ % a k s
flicker	" " f l I $ k e r
geas	" g e: $ a s
blupp	" b l u0 p
villde	" " v I l $ d e
ploppa	" p l O $ p a
ooj	" " u: $ O j
ninnee	" " n I $ n i:
håa	" h o: $ a
lamlat	" " l A: m $ l a t
spinge	" s p I N $ e
öe	" " 2: $ e
nåx	" n O k s
åjå	O x\ o:
geka	" g e: $ k a
babiäsana	b a $ b I $ e $ " " s a $ n a
deit	" d e j t
storebrossa	" " s t u: $ r e $ b r O $ s a
sicken	" s I $ k e n
tytte	" t Y $ t e
vappe	" v a $ p e
hunnens	" " h u0 $ n e n s
torona	t U $ " r o: $ n a
vääg	" v E: g
brö	" b r 2:
säppe	" s e $ p e
fötte	" f 9 $ t e
brrr	b e: $ e r $ " e r
traktoj	t r a k $ " " t O j
pått	" " p O t
båka	" " b o: $ k a
färe	" " f E: $ r e
honnä	h O $ " n E:
hath	" h A: t
dåtts	" " d O t s
blidde	" b l I $ d e
blåse	" b l o: $ s e
ins	" I n s
sakona	" s A: $ k U $ n a
oransj	U $ " r a n` s`
oa	" " u: $ a
thattis	t a $ t I s
nähänä	n e $ " h E: n E:
finget	" f I N $ e t
svåt	" s v o: t
gaass	g a $ " " a s
bässe	" b e $ s e
såck	" s O k
sisk	" s I s k
mänskona	" " m e n $ x\ U $ n a
kippax	" " s' I $ p a k s
bru	b e: $ e r $ " }:
påa	" " p o: $ a
spingde	" s p I N $ d e
nena	n e $ n a
tso	" t s U
soov	s U $ u: v
högre	" " h 2: $ g r e
br	b e: $ e r
luk	" l u0 k
hinre	" " h I n $ r e
dong	" d O N
dåt	" d o: t
taal	" " t a l
bräddra	" " b r E: d $ % d r A:
tsä	" t s E:
jobbit	" " j O $ b I t
blundax	" " b l u0 n d $ % a k s
daar	" d A: r
skorre	" s k O $ r e
dåle	" " d o: $ l e
låssa	" " l O $ s a
däen	" " d E: $ e n
tsåll	" t s O l
ych	Y $ " s`
tollax	" " t O $ % l a k s
kanne	" k a $ n e
jöja	" j 9 $ j a
natti	n a $ t I
söldpadda	s 9 l d $ % p a $ d a
fante	" " f a n $ t e
smojset	" s m O j $ s e t
skriskor	" " s k r I $ s k U r
dätta	" d e $ t a
thättis	" " t E: t $ t i: s
braa	" " b r o:
fie	" " f i: $ e
barbina	b a r $ b I $ n a
blann	" b l a n
åte	" " o: $ t e
ngä	e n $ " g E:
gillax	" " j I $ l a k s
pch	p s`
såä	" s O E
skördetrössona	" " x\ 2: $ d` e $ % t r 9 $ s U $ n a
änta	" e n $ t a
tr	" t r a
dja	d j a
kecka	" k e $ k a
ankena	" " a N $ k e $ n a
un	" u0 n
sriver	s r i: $ v e r
mum	" m u0 m
gåk	" g o: k
jättehårt	" " j e $ t e $ % h o: t`
gungax	" " g u0 N $ % a k s
fl	" " e f $ e l
penne	" " p e $ n e
doom	" " d u: $ U m
jat	" j a t
kåck	" k O k
atan	a $ t a n
gän	" j E: n
smö	" " s m 2:
papekoja	p a $ p e $ % k O $ j a
dette	" d e t
thatten	" t a $ t e n
liltomte	l I l $ " t O m $ t e
jode	" j u: $ d e
gock	" g O k
handå	" h a n $ d o:
jah	" " j a
jädd	" j e d
lämma	" " l e $ m a
nannan	" " n a $ n a n
rullax	" " r u0 $ l a k s
plaskax	" " p l a s k $ % a k s
mysli	m Y $ " s l i:
jeepe	" j i: $ p e
skrisko	" " s k r I $ s k U
jämt	" j e m t
flickebäbis	" " f l I $ k e $ % b E: $ b I s
ähe	E:
jiip	" j i: $ i: $ " p e:
osch	O $ s`
hmhm	" h u0 m m
tomtegröt	" " t O m $ t e $ % g r 2: t
älp	" e l p
dörre	" d 9 $ r e
fiskana	" " f I s k $ a $ n a
öppax	% 9 p $ % a k s
tädet	" t E: $ d e t
körit	" " s' 2: $ r I t
tsumma	" " t e: $ % s u0 $ m a
hja	" " j a
glö	" g l 2:
böck	" b 9 k
vj	" v j
enträ	" " e: n $ % t r E:
näja	n e $ j a
gjo	" j u:
stättlän	" " s t e $ t e l E: n
lastax	" " l a s t $ a k s
demmes	d e $ m e s
deeng	d e $ " e N
kng	k N
hutti	" " h u0 $ t I
enna	" e $ n a
iblann	" " i: $ b l a n
chöt	" x\ 2: t
deas	d e: $ a s
äf	E: v
lisebil	l I $ s e $ " b i: l
hära	" " h E: $ r a
ketet	k e $ " t e: t
teas	" " t e: $ a s
hajku	" h a j $ k U
oitt	" O j $ t
jobbax	" " j O b $ % a k s
bonnastollen	" " b O $ n a $ s t O $ l e n
tool	" t u: l
pyton	" p y: $ t O n
gäje	" g e $ j e
beättax	" " b e: $ % e $ t a k s
bölla	" b 9 $ l a
samme	s a $ m e
lesaker	l e $ % s A: $ k e r
lö	" l 2:
häsana	h e $ " " s a $ n a
lassil	" l a $ s I l
chin	s' I n
tsa	t s a
pinde	" " p I n $ d e
poke	" " p o: $ k e
thör	" " t 2: r
klopp	" k l O p
kojv	" " k O j $ % v e:
bae	" " b e
vika	" " v i: $ k a
väge	" " v E: $ g e
mäh	" m E:
täffa	" t e $ f a
menax	" " m e: n $ % a k s
hungri	" " h u0 N $ r I
ejda	" " e j $ d a
taar	t a $ a r
nelis	n e $ " l i: s
vää	" v E:
hådet	" h o: $ d e t
hoss	h O s
bjön	" b j 2: n
döge	" " d 2: $ g e
jäppa	" j e $ p a
vaam	" v a m
ponniena	p U $ " n j e: $ n a
hammax	h a $ m a k s
ij	I j
sprutax	" " s p r }: t $ % a k s
smyge	" s m y: $ g e
linglånga	" " l I N $ % l O N $ a
bäde	" " b E: $ d e
ched	" s' e: d
våppa	" " v o: p $ p a
smakax	" " s m A: k $ % a k s
aton	a $ " t O n
hepp	h e p
äffä	e f E:
hääm	" " h E: m
batax	b a $ " t a k s
omme	" U $ m e
öhm	9 m
hjaa	" " h o: $ j A:
näna	" " n E: $ n a
badring	" " b A: d $ % r I N
sassax	" s a $ % s a k s
nänä	n e $ " n E:
änne	e $ n e
båx	" " b O k s
nåa	" " n o: $ a
losa	" l u: $ s a
chatten	" " s' a $ t e n
nakefis	" " n A: $ k e $ f I s
ämta	e m $ t a
åä	O E
sassa	" s a $ s a
mna	e m $ n a
chä	" s' E
långk	" " l O N $ k
slyga	" " s l y: $ g a
kla	" k l a
bam	" " b a m
sissa	" s I $ s a
masmamma	" " m A: s $ % m a $ m a
see	" " s i:
jaaj	" " j A: $ a j
lannet	" l a $ n e t
vaffor	" v a $ f U r
däka	" " d E: $ k a
hjä	" j E:
tådde	" " t O $ d e
tytha	t Y $ t a
cyklen	" s y: $ k l e n
emn	e: $ e m $ " e n
jök	" " j 2: k
psreis	p s r e j s
fedit	f e $ " d i: t
hanlax	" " h A: n $ l a k s
mussit	m u0 $ " s i: t
kang	" k a N
lost	" " l O s t
bokä	" " b u: k $ % E:
sampe	" s a m $ p e
ässä	e $ s E
tata	t a $ " t A:
piil	" p i: $ l
kissenödi	k I $ s e $ % n 2: $ d I
båsta	" b o: $ s t a
fikax	" " f i: $ k a k s
dein	d e $ " i: n
sast	" " s a s t
parkar	" p a r $ k a r
thääg	" " t E: g
kim	" " s' I m
taktorer	t a k $ " t u: $ r e r
kåckan	" k O $ k a n
tjen	" t s' e: n
tn	" " t e: $ e n
ente	" " e: n $ t e
unda	" " u0 n $ d a
thar	" t a r
gägg	" j e g
ov	" " u: $ v e:
sobe	" s o: $ b e
hässä	h e $ s E
busi	" " b }: $ s I
ritax	r I $ " t a k s
äk	E: k
hajn	" h a j $ n
peet	" p e t
prrm	p r r m
söke	" " s 2: $ k e
kus	" k U s
morfas	" m O r $ f a s
ään	E: n
häp	" " h E: p
benbygge	" " b e: n $ % b Y $ g e
honden	h O n $ d e n
snäckoj	" " s n e $ k O j
såång	s o: $ " O N
kroner	" " k r u: $ n e r
gisa	" g i: $ s a
mafin	m a $ " f i: n
dnu	d e: $ e n $ " }:
tjov	" s' O v
boppå	" " b O $ p o:
bega	b e $ g a
vaknax	" " v A: k $ % n a k s
sydd	" s Y d
bäjbi	" b e j $ b I
pyttelite	" " p Y $ t e $ % l i: $ t e
häch	h e $ " s`
kinta	" " s' I n $ t a
pom	" p O m
schå	" s` o:
sänga	" " s e N $ a
käckax	" " s' e $ k a k s
sään	" s E:
bycke	" b Y $ k e
sänge	" " s e N $ e
mommå	m U $ " m o:
batha	" b A: $ t a
hjäme	" j E: $ m e
bätte	" b e $ t e
mang	" m a N
dål	" d o: l
trampax	" " t r a m p $ % a k s
kama	k a $ m a
oå	" " u: $ % o:
hängit	" " h e N $ I t
danga	" " d a N $ a
hadde	" h a $ d e
blåcke	" " b l O $ k e
glåck	" g l O k
läpo	" " l E: $ p U
een	" e: n
tallet	" t a $ l e t
nne	" n j n
skördetrössa	" " x\ 2: $ d` e $ % t r 9 $ s a
bryte	" " b r y: $ t e
äth	" E: t
hånne	h O $ n e
tra	" t r a
sticke	" s t I $ k e
igga	I $ g a
tatte	" " t a $ t e
kåka	" " k o: $ k a
öa	" " 2: $ a
klänni	" " k l e $ n I
öhö	" " 2: $ h 2:
mockax	" " m O $ k a k s
sääl	" s E: l
nåndans	" n O n $ d a n s
gräbde	" " g r e $ d
kinga	" " s' I N $ a
tågvagnen	" " t o: g $ % v a N $ n e n
tat	t a t
ys	" " y: s
förskräcklit	f 9 $ " s` k r e $ k l I t
sovde	" " s o: v $ d e
slädda	" " s l e $ d a
tjitta	" s' I $ t a
geggax	" " g e $ g a k s
dinget	" d I N $ e t
ovanpå	" " o: $ v a n $ % p o:
sti	" s t I
stoa	" s t u: $ a
lyltomte	" l Y l $ t O m $ t e
kappax	" " k a p $ % a k s
alltså	a l t $ " s o:
bää	" " b E:
haplapp	h a $ p l a p
änte	" e n $ t e
nuä	" n u: E
pelar	" " p e: $ l a r
chåx	" s' O k s
råtter	" " r O $ t e r
mume	m }: $ m e
blinna	" " b l I $ n a
tanborsten	t a n $ % b O $ s` t` e n
klättax	" " k l e $ t a k s
hätt	" h e t
jae	" j A:
dott	" d O t
chon	" s' O n
kossena	" " k U $ s e $ n a
ninen	" " n I $ n e n
chunga	" s' U N $ a
bambile	b a m $ " b i: $ l e
dusja	" d a $ s` a
strumper	" " s t r u0 m $ p e r
uut	" }: t
gobben	" g O $ b e n
muun	" m }: n
tjumma	s' u0 $ m a
leksa	" " l e: k $ s a
häxona	" " h e k $ s U $ n a
såpp	" " s o: p $ % p e:
bäppä	" b e $ p E
mommoä	m U $ m O E
sääng	" " s E: $ % e N
håå	" h o:
nnn	" " e n $ e n $ " e n
pl	" " p e: $ % e l
hemst	" h e m s t
sake	" s A: $ k e
podet	" p u: $ d e t
neme	" " n e: $ m e
thättestor	t e: $ h e $ t e $ % s t u: r
gjodde	" j U $ d e
mofa	m U $ f a
hätten	" " h e $ t e n
uch	u0 s`
trillax	" " t r I $ l a k s
undan	" " u0 n $ d a n
fiskespö	" " f I $ s k e $ % s p 2:
törti	" " t 9 $ t` I
ämte	e m $ t e
hönä	" " h 2: $ % n E:
pot	" p o: t
tjöpa	" s' 2: $ p a
hond	h O n d
dnä	" d n E:
ämt	e m t
heckta	" h e k $ t a
grode	" " g r u: $ d e
thäcketoj	t e $ k e $ t O j
jättelite	" " j e $ t e $ % l i: $ t e
nånas	" " n o: $ n a s
pockax	" " p O $ k a k s
vovva	" " v O $ v a
betsor	" " b e: t $ % s O r
nikas	" n I $ k a s
tannboste	t a $ " n $ b u: $ s t e
skan	" " s k a n
bäte	" " b E: $ t e
laddi	" " l A: d $ % d I
aaj	" " o: $ % j i:
eme	" " e m
myte	m Y $ t e
sokodil	s U $ k U $ " d i: l
jabbax	" " j a $ b a k s
hagg	" " h a g
dosi	d u: $ s I
igge	I $ g e
ekch	" " e: k $ x\
äppe	e $ p e
bäpa	" " b E: $ p a
chinne	" s' I $ n e
pöket	" p 2: $ k e t
oth	O t
brannbilen	" b r a n $ % b i: $ l e n
mess	m e s
bädona	" " b E: $ d U $ n a
pya	p y: $ a
jar	" j a r
knapax	" " k n A: p $ % a k s
vacka	" " v a $ k a
fuge	" " f }: $ g e
räva	" " r E: $ v a
thycke	t Y $ k e
sakä	" " s A: k $ % E:
homa	" h u: $ m a
tött	" t 9 t
dyppla	" d Y $ p l a
scha	" x\ a
hajej	" h a $ j e j
sicke	" s I $ k e
thladdi	t $ l a $ d I
smicko	" " s m I $ k U
vox	" " v O k s
ågä	o: g E:
juax	x\ u0 $ " a k s
hääs	" " h E: s
fyge	" " f y: $ % j e:
däfa	" " d E: $ f a
lisabella	" " l i: $ s a $ b e $ l a
nånga	" n O N $ a
riffa	" " r I $ f a
håsnåg	" h o: $ s n o: g
fapo	" f A: $ p U
pillit	p I $ " " l i: t
tod	" t u: d
grakameje	g r a $ " k A: $ m e $ j e
nöff	" n v
tubbithe	" " t u0 $ b I $ t e
mammää	m a $ " " m E:
fabos	" " f A: $ b u: s
tjänna	" s' e $ n a
topa	" t o: $ p a
sittax	" " s I t $ % a k s
ååa	o: a
huan	h U $ " a n
kjar	" s' r
gua	g U $ a
äe	" E: $ e
mejä	" " m e $ j E
piter	" p i: $ t e r
ade	a $ d e
dell	" d e l
gedde	" " j e $ d e
vevax	" " v e: v $ % a k s
kävskopare	" " s' E: v $ % s k u: $ p a $ r e
gobba	" g O $ b a
blöll	" " b l 9 l
däää	" d E: E
fädi	" " f E: $ d I
dansjumpa	" " d a n s $ % j u0 m $ p a
dåbe	" d o: b
beella	b e $ " e $ l a
talliksharva	" t a $ l I k $ s` a r $ v a
motorhålet	" " m u: $ t U r $ % h o: $ l e t
särten	" " s E: $ t` e n
ägge	e $ g e
gifti	" " j I f $ t I
sole	" s o: $ l e
gålla	" g O $ l a
åderi	" " o: $ d e $ " r i:
ämä	e $ m E
uä	u0 E
sääck	" s E: k
åde	" " o: $ d e
prang	p r a N
klättrax	" " k l e $ t r a k s
ähää	e $ % h E:
bostar	" b O $ s t a r
nattslaska	" " n a t $ % s l a $ s k a
bitax	b I $ " t a k s
keng	" s' e N
öppe	9 $ p e
tjass	" s' a s
gamm	" " g a m
gatta	" g a $ t a
dingdonkicka	" " d I N $ " d o: N $ % k I $ k a
mammaä	" " m a $ m a $ % E:
chätt	x\ e t
tjålj	" s' O l j
åkx	O k s
buuss	" b u: s
kjö	" " s' 2:
affö	a $ " f $ 2:
smulk	" " s m u0 l k
lelefant	l e $ l e $ % f a n t
sluckan	" " s l u0 $ k a n
drä	" d r E:
dååm	" d o: m
duf	" " d }: v
gäche	" " j e s`
jåbe	" j o: $ b e
åve	" " o: $ v e
dukti	d u0 k $ " t i:
denä	d e $ " " n E:
gädde	" " j e $ d e
kaven	" " k A: $ v e n
flyplan	" " f l y: $ % p l A: n
haffx	" h a f k s
jinvagn	" j I n $ % v a N n
fårä	" " f o: $ r E
fåkepoj	" f o: $ k e $ p O j
johå	j U $ " h o:
luttax	" " l }: t $ t a k s
ant	" a n t
tomde	" " t U m $ d e
okey	" u: k Y
gnoen	" " g n u: $ e n
osj	u: $ e s $ % j i:
gål	" " g o: l
dööt	" " d 2: $ 2: t
lollda	" l O l $ d a
seng	" s e N
backax	b a $ " k a k s
kakae	k a $ k a $ " e:
ähmn	E: m n
tunnen	" " t u0 $ n e n
tofflä	" " t O $ f l E:
litte	l I $ t e
nal	" n a l
potä	p O $ " t E:
bullrax	" " b u0 l $ r a k s
fye	" " f y: $ e
fåre	" f o: $ r e
schove	" s` o: $ v e
dussa	" " d u0 $ s a
ballo	b a $ l U
tss	" t s
hätte	" " h e $ t e
däga	" " d E: $ g a
lolit	l U $ " l i: t
dabbi	" " d a $ b I
bante	b a n $ t e
äö	2:
doj	" d O j
fygpan	" f y: g $ p a n
sillan	" s I $ l a n
båck	" " b O k
mökax	" " m 2: $ % k a k s
åvv	O $ v
threa	" t r e: $ a
heee	" " h e: $ e
rättefort	" " r e $ t e $ f O r
hång	" " h O N
olyckona	" " u: $ l Y $ k U $ n a
kopan	k U $ " p A: n
mnana	" e m $ e n $ " " A: $ n a
russine	" " r u0 $ s I $ n e
hmnä	" h u0 m n E:
sigel	" " s i: $ g e l
thöra	" " t 2: $ r a
ste	" s t e
puttu	" p U $ t U
jyygg	" j Y Y g
däte	" " d E: $ t e
fali	" " f A: $ l I
göng	" " j 9 N
nåtta	" " n O $ t a
ooss	" " u: $ O s
morn	" " m U n`
samp	" s a m p
slu	" " s l u0
aah	" o:
um	" " }: $ % e m
månn	m O n
moä	m Y E
bossa	" " b O $ s a
mittä	m I $ t E
sli	" s l i:
cila	" " s i: $ l a
gea	g e: $ " A:
ker	" k e r
dansax	" " d a n s $ % a k s
häär	h e $ " E: r
stänke	" s t e N $ k e
rive	" " r i: $ v e
hmn	" h u0 m n
mäsa	" " m E: $ s a
hässe	" " h e $ s e
måsja	" " m O $ s` a
måche	" " m O s`
gafflana	" " g a $ f l a $ n a
sadl	" s e j $ d e l
kåd	" " k o: d
bat	b a t
manga	m a N $ g a
ötta	9 $ t a
ue	" j u:
bäjbisen	" b e j $ b I $ s e n
lultomta	" " l }: l $ % t O m $ t a
ol	" u: l
taka	" t a $ k a
klänn	" k l e n
veda	" " v e: $ d a
gåbba	" g O $ b a
ninin	n I $ " n i: n
bn	" " b e: $ e n
vats	" v A: t s
dåda	" " d o: $ d a
srött	" " e s $ % r 9 t
tankebil	" " t a N $ k e $ % b i: l
aje	" " a $ j e
slänning	" " s l e $ n I N
chett	x\ e t
blottit	" " b l O $ t I t
slåx	" s l O k s
böckena	" b 9 $ k e $ n a
moteped	" " m u: $ t e $ % p e: d
kj	" " s'
hyndar	" " h Y n $ d a r
joa	" " j u: $ a
härmans	" " h e r $ m a n s
kåss	" k O s
måssa	" " m O $ s a
mb	e m $ b e:
dliten	d e $ s I $ " l i: $ t e n
dammit	" " d a $ m I t
dålit	" " d o: $ l I t
spinga	" s p I N $ a
sebe	s e $ " b e:
ovepå	O $ v e $ " p o:
coneli	k O $ n e $ l i:
jicka	" j I $ k a
taktopulling	t a k $ " t o: $ p u0 $ l I N
leksakä	" " l e: k $ s A: k E
blaand	" b l A: $ s a n d
möke	" " m 2: $ k e
stenana	" " s t e: n $ % A: $ n a
köpx	" " s' 2: $ p e k s
bek	b e $ " k o:
mejn	" " m e j $ n
däi	" d e j
hånd	" " h o: N
gäggax	" j e $ g a k s
fölle	" " f 9 $ l e
tsi	" t s I
jyggen	" j Y $ g e n
farbro	" " f A: r $ % b r u:
sesse	s e s
kackax	" " k a $ k a k s
pinnana	" " p I $ n a $ n a
tyt	" t Y t
håe	" h o: $ e
klänne	" " k l e $ n e
thidhuset	" t i: d $ % h }: $ s e t
nalli	" " n a $ l I
mölet	" " m 2: $ l e t
ajä	" " a $ j E
pojkana	" " p O j k $ a $ n a
taffetopp	" " t a $ f e $ t O p
toj	" t O j
bukar	" " b }: $ k a r
pappe	" " p a $ p e
vantax	v a n $ " t a k s
ojs	" O j s
älpa	" e l $ p a
banstolen	" " b A: n $ % s t u: $ l e n
dettaa	d e $ " t A:
gras	g r a s
iss	" a j s
blockit	b l O $ " " k i: t
bäddax	" " b e $ d a k s
sul	" " s }: l
kattä	" " k a $ t E
lyffkan	" " l Y f $ k a n
bottar	b O $ t a r
aich	" a j s`
neaä	" n i: E
jeeeep	" j i: i: p
färdit	f e r $ " d i: t
cykala	s Y $ k a $ l a
jin	" j I n
thator	" " t A: $ t U r
mysen	" m y: $ s e n
tree	" t r e: $ e
torer	" " t u: $ r e r
jenna	j e $ n a
näje	n e $ j e
dammsiga	" " d a m $ s I $ g a
millas	" " m I $ l a s
kt	k t
paa	" p A:
någo	" " n o: $ g U
mösja	" m 9 $ s` a
kni	" k n I
nåne	" n O n
nnää	" n E:
vav	" " v A: v
bande	b a n $ d e
letol	l e $ " t o: l
haagn	" h A: g n
börne	" b 2: $ n` e
kåa	" " k o: $ a
tje	" s' e
bråkax	" " b r o: k $ % a k s
ramlaj	" " r a m $ l a j
dro	d r U
too	" t o:
plastduk	" " p l a s t $ % d }: k
thädet	" " t E: $ d e t
negnar	" n e: $ g n a r
baje	" b a $ j e
bostä	" " b u: $ % s t A: d E
åmma	O $ m a
atso	a t $ s O
hukhus	" h }: k $ % h }: s
koss	" " k U s
thää	" " t E:
lastbila	" " l a s t $ % b i: $ l a
gägge	" j e $ g e
gege	" " g e: $ g e
tasi	t a $ " s i:
hove	" " h u: $ v e
nj	" n j
nossa	" " n O $ s a
nae	" n a j
möl	" " m 2: l
kjä	s' e n
döj	" d 9 j
pippanduk	" " p I $ p a n $ % d }: k
lhjäppa	e l $ j e $ p a
hjäppe	" " j e $ p e
paall	" p A: l
vs	" " v e: $ % e s
chova	s` O $ v a
törtels	" " t 9 $ t` e l s
nagnar	" n A: $ g n a r
gete	" j e: $ t e
seen	" " s i: n
dista	d I $ s t a
kroto	k r U $ t U
toff	" t O f
kevis	" k e $ v I s
tarka	" t a r $ k a
glå	" " g l o:
vnna	v $ n a
fäm	" " f e m
armana	a r $ " m A: $ n a
tjatt	" s' a t
möcha	" m 9 $ s` a
vamt	" v a m t
adeleje	a $ " d e l e: $ j e
åmdå	O m $ d O
bäa	" " b E: $ a
ämme	e $ m e
bååt	" b o: t
havv	" " h A: v $ % v e:
avokroto	a $ v U $ " k r o: $ t O
sack	" s a k
farfa	" " f a r $ f a
orans	" " u: $ r a n s
gunger	" " g u0 N $ e r
räcebilen	r e $ " " s e: $ % b i: $ l e n
tackä	t a $ " k E
tock	" t O k
hacksp	" " h a k $ s p
tena	" " t e: $ n a
petson	" " p e: t $ % s o: n
bebbe	b e $ b e
uppaa	" " u0 p $ % a
tågbana	" " t o: g $ % b A: $ n a
nähäää	" " n e $ % h E: E
määs	" m E: s
mägås	" " m E: $ % g o: s
pas	" p A: s
toog	" t u: g
pås	" " p o: s
goke	" g o: $ k e
undrax	" " u0 n $ d r a k s
hoppeskuttet	" " h O p $ e $ % s k u0 $ t e t
nege	" " n e: $ g e
bilbåt	" " b i: l $ % b o: t
bjönen	b j 9 $ n e n
hänner	" h e $ n e r
jogobb	" " j O $ O b
häse	" " h E: $ s e
jätteont	" " j e $ t e $ % U n t
daja	d a $ " j A:
syska	" " s Y $ s k a
korbitar	" " k u: r $ % b i: $ t a r
vafö	v a $ " f 2:
däh	" " d E:
äst	E: s t
dinte	" " d i: n $ t e
bellä	b e $ " l E:
syta	" " s y: $ t a
tiö	t I $ 9
kåvv	" " k o: $ v e: $ " v e:
ft	f t
täda	" t E: $ d a
sänggalta	" " s e N $ % g A: l $ t a
sänn	" s e n
saal	" s A: l
psaps	" " s a p s
mabba	m a $ b a
bålla	" " b O $ l a
hma	$ m a
kna	" k n a
händena	" " h e n $ d e $ n a
nigge	" n I $ g e
fäj	" " f e j
smutsax	" " s m u0 t $ s a k s
rattana	" " r a $ t a $ n a
dosax	d U $ " " s a k s
tånnen	" " t O $ n e n
matä	" " m A: t $ % E:
dåbba	" " d o: b $ b a
cyklax	" " s Y $ k l a k s
blommona	b l U $ m U $ n a
orna	" " u: $ n` a
ringe	" " r I N $ e
nom	" n o: m
enne	" e $ n e
slaj	" s l a j
hjäm	" " j e m
orkax	O r $ " " k a k s
bäpä	" " b E: p E
näd	" n E: d
sittör	s I $ " t 2: r
murtoa	" m u0 $ t` U $ a
tarr	" t a r
bolle	" " b O $ l e
nemma	n e $ m a
tjåll	" s' O l
dörra	" " d 9 $ r a
snä	" s n E:
höä	" h 9 E
sääld	" s E: l d
uja	u0 $ j a
giftit	" " j I f $ t I t
fjedana	" " f j e: $ d a $ n a
glasfisk	" " g l A: s $ % f I s k
funkax	" " f u0 N $ % a k s
kjaha	" s' a
tattungana	" " t a $ t u0 N $ g a $ n a
kaninena	k a $ " n i: $ n e $ n a
hästä	" " h e s t $ % E:
farfasbilana	" " f a r $ % f A: s $ b I $ % l A: $ n a
aldi	" " a l $ d I
gng	g N
päbis	" p E: $ b I s
simla	" " s I m $ l a
behöve	b e $ " h 2: $ v e
velefantena	v e $ l e $ % f a n $ t e $ n a
smögös	" s m 2: g 2: s
ponna	" " p O $ n a
jättetor	" " j e $ t e $ % t u: r
täk	" " t e k t
hannä	h a $ " n E:
bejbisen	" b e j $ b I $ s e n
tytta	" t Y $ t a
däja	" d e $ j a
dätä	" " d E: $ t E
jättetung	" " j e $ t e $ % t u0 N
keta	" k e: $ t a
mönö	" " m 2: $ % n 2:
doe	" " d u: $ e
kech	" k e s`
däar	" " d E: $ a r
chlart	k l a $ " t`
barbiästana	b a r $ b I $ e $ " " s t A: $ n a
kakena	" " k A: $ k e $ n a
duä	" d a E
tse	" " t s e
gåmman	" g O $ m a n
hil	" " h i: l
ööö	2: 9
lamper	" " l a m $ p e r
mänsona	" " m e $ n I $ s U $ n a
loko	l U $ k U
dälla	" d e $ l a
ie	I
bysse	" b Y $ s e
glölampa	" g l 2: $ % l a m $ p a
tollar	" " t O $ l a r
paass	" p A: s
jol	" j O l
sänger	" s e N $ e r
slad	" s l a d
tanbost	t a n $ b O s t
tsåg	" " t e: $ % s o: g
ifast	" " i: $ % f a s t
vattet	" " v a $ t e t
höl	" h 2: l
gegas	" " g e: $ g a s
nthn	n t n
grö	" " g r 2:
äfö	E: f 2:
tjola	" " s' u: $ l a
leksakena	" " l e: k $ % s A: $ k e $ n a
onna	" O $ n a
thida	" " t i: $ d a
giip	" g i: p
gåss	" " g o: $ s e s
mänsor	" " m e n $ s U r
tjönne	" s' 9 $ n e
läsit	" " l E: $ % s i: t
kaa	" k A:
eche	e $ k e
tänte	" t e n $ t e
gockax	" g O $ " k a k s
äffe	e $ f e
tompisa	" " t U m $ % p i: $ s a
fassar	f a $ s a r
såsåll	" " s o: $ s O l
tåll	" " t O l
thax	" t a k s
ficke	" " f I $ k e
tuffetåget	" t u0 $ f e $ % t o: $ g e t
täps	" t E: p s
luffe	" l u0 $ f e
huhu	" h U h }:
långsamet	" " l O N $ % s a m e: t
khjul	k o: $ % j }: l
trasi	" " t r A: $ s I
bupp	" b u0 p
babygröten	" " b E: $ b I $ % g r 2: $ t e n
dossa	d O $ s a
mega	" " m e: $ g a
tufftåg	" " t u0 f $ % t o: g
thinglar	" " t I N $ l a r
prickor	" " p r I $ k U r
lisebila	l I $ s e $ " b i: $ l a
hnnn	h $ n
lommä	" l U m E
brrrm	b r r m
neå	n e $ o:
hjäp	" j E: p
mutsa	" " m }: t $ s a
färil	" " f E: $ r I l
däsa	" " d E: $ s a
dokto	d O k $ t U
tannar	" " t a $ n a r
sränset	s r e n $ s e t
gäg	" j E: g
sopax	" " s u: p $ % a k s
fafar	f a $ " f A: r
båmma	" " b O $ m a
jamla	" j a m $ l a
thattnet	" t a t $ n e t
dotton	" " d O $ t O n
bandö	" " b a n d $ % 2:
pon	" p O n
vel	" v e: l
tannax	t a $ " n a k s
pojka	" " p O j $ k a
addos	a $ " d u: s
jöd	" " j 2: d
äla	" E: $ l a
motocykel	m U $ t U $ % s Y $ k e l
spi	e s $ p e: $ " i:
sonsalva	" " s o: n $ % s a l $ v a
gappax	" " g A: p $ % p a k s
däde	" " d E: $ d e
håm	h O m
tåck	" " t O k
junda	" " j u0 n $ d a
totha	" " t u: $ t a
gabbasch	" g a $ b a s`
köda	" " k 2: $ d a
kea	" k e: $ a
baga	" " b A: $ g a
docker	" " d O $ k e r
nla	e n $ l a
balansskor	b a $ " " l a n s $ % s k u: r
pt	p t
startsp	" " s t A: t` $ % s` p
vinte	" v I n $ t e
tjaatt	" s' a a t
äje	e $ j e
sammabin	" " s a $ m a $ % b i: n
bm	" " b e: $ % e m
åg	o: g
åsje	" o: s $ j e
tortet	t U $ " " t` e: t
åo	" " o: $ U
vaf	" " v A: $ % e f
bepp	b e p
kannabis	" k a $ n a $ b I s
hanlar	" " h A: n $ l a r
chäna	" " s e: $ % h E: $ n a
pygga	" p Y $ g a
thygplanet	" t y: g $ % p l A: $ n e t
kaffa	" k a $ f a
syltin	s Y l $ " t i: n
bmma	" " b e: $ e m $ m a
dåj	" " d o: $ % j i:
pok	" p o: k
blådare	" " b l o: $ d a $ r e
gega	" " g e: $ g a
slickax	" " s l I $ k a k s
tocka	" t O $ k a
mamm	" " m a m
ringsinget	" " r I N $ s I N $ e t
häpp	" h e p
fafa	" " f a $ f a
hattso	" " h a t $ s U
höss	" " h 9 s
våppaa	" " v o: p $ p A:
myck	" m Y k
däje	" d e $ j e
julganen	" " j }: l $ g A: $ n e n
huus	" h u0 s
jommi	" j O $ m I
dlo	" " d e: $ e l $ " u:
ästen	e $ s t e n
tad	t a d
dså	" " d e: $ e s $ % o:
tååg	" t o: o: g
dält	" d e l t
barna	" " b A: $ n` a
utanför	" " }: $ t a n $ % f 2: r
trum	" " t r u0 m
glomma	" " g l U $ m a
klarax	" " k l A: r $ % a k s
thumpan	t u0 m $ p a n
peil	" p e j l
gika	" " g i: $ k a
toja	t O $ j a
vistade	" " v I $ s t a $ d e
mof	" m O f
krockax	" " k r O k $ % a k s
ick	i: $ s e: $ " k o:
jöra	" " j 2: $ r a
kenna	" k e $ n a
sööl	" " s 2: $ % 2: l
röket	" " r 2: $ k e t
singa	s I N $ a
pomenad	p U $ m e $ " n A: d
älä	e $ l E
laktra	l a k $ t r a
bätta	" b e $ t a
gathe	" " g A: $ t e
lesak	l e $ % s A: k
denge	" d e N $ e
tjåång	" s' O O N
berättax	b e $ " r e $ t a k s
vänstearm	" " v e n $ s t e $ a r m
rocket	" r O $ k e t
råttena	" " r O $ t e $ n a
rättemycke	" " r e $ t e $ % m Y $ k e
farfas	" " f a r $ f a s
cyka	" s y: $ k a
sängde	" " s e N $ d e
tått	" " t O t
lynnä	" l Y n E:
nga	e N $ g a
darka	" d A: r $ k a
passax	p a $ " s a k s
fassa	f a $ s a
krotobil	k r U $ t U $ % b i: l
fetto	" " f e: $ t O
lyssa	" " l Y $ s a
jåa	" j o: $ a
köj	" k 9 j
lesake	" l e $ s a $ k e
sklintade	s k l I n $ t a $ d e
naej	n a $ " e j
bika	" " b i: $ k a
kjin	" " s' I n
jipä	" j I p E
dobbax	" " d O $ b a k s
päbisa	" p E: $ b I $ s a
kissegubben	k I $ s e $ % g u0 $ b e n
mjaoi	" m j a*U $ i:
männ	" m e n
festisen	f e $ " s t i: $ s e n
måja	" " m o: $ j a
köpp	" " s' 2: p $ % p e:
app	" " a p
skrumejsen	" s k r u0 $ m e j $ s e n
gömle	" " j 9 m $ % l e:
hada	" h A: $ d a
nåå	" n o:
gåckå	" " g O k o:
dåck	" " d O k
lassä	" " l a $ % s E:
gise	" " j i: s
tallriksharvar	" " t a l $ r I k s $ % h a r $ v a r
stax	" " s t a k s
fla	" f l a
emellan	" e $ m e $ l a n
srån	s r o: n
hoon	" h u: n
blanse	b l a n $ % s e:
chlax	k l a k s
taall	" t A: l
kigen	s' I $ " j e n
tååm	" t o: m
römaneter	" r 2: $ m a $ % n e: $ t e r
ååh	o:
nanax	n a $ " n a k s
joå	" " j U $ % o:
däfö	" d e f 2:
knikenet	" " k n i: $ k e $ n e t
tjöd	" s' 2: d
difö	d I f $ " 2:
chenga	" s' e N $ a
most	" " m O s t
dingdonk	" " d I N $ " d O N k
tanin	" " t A: $ n I n
nm	" " e n $ e m
have	" h A: $ v e
taktor	" " t A: k $ t O r
biina	" b i: $ n a
majen	m a $ j e n
fya	" " f y: $ a
sram	" " e s $ % r A: m
kåx	k o: r k s
näne	" " n E: $ n e
babba	" b a $ b a
åli	o: $ l I
banstol	" " b A: n $ % s t u: l
daä	" d e E
åckan	O $ k a n
käva	" " s' E: $ v a
fits	f I t s
muh	m u0 $ " h o:
torkax	" " t O r k $ % a k s
bjö	" b j 2:
bäbisj	" b E: $ b I $ s`
piskax	" " p I s k $ % a k s
hange	" h a N $ e
krollkaren	" " k r O l $ k a $ r e n
snige	" " s n i: $ g e
hjule	" j }: $ l e
nei	" n e j
chete	" " s e: $ % h e: $ t e
tilla	" t I $ l a
sågak	" " s o: g $ a k
oe	" " u: $ e
jijia	j I $ " j i: $ a
näen	" " n E: $ e n
tjika	" s' i: $ k a
ådis	" " o: $ d I s
srokodilen	s r U $ k U $ " d i: $ l e n
pova	" p o: $ v a
thappet	" t a $ p e t
lall	" l o: l
daat	" d A: t
tsole	" t s O l
nange	" n a N $ e
filmölken	" " f I l m $ 9 l $ k e n
thinnit	t I $ " n i: t
kagga	" " k a $ g a
hjäpp	" " j e p
lastbilana	" " l a s t $ b i: l A: $ n a
kligga	" k l I $ g a
lyde	" " l y: $ d e
bunka	" " b u0 N $ k a
kännä	" s' e n E:
hösläkta	" " h 2: $ % s l e k $ t a
geppa	" g e $ p a
off	" " O f
ljaa	j A:
bummaa	" " b u0 m $ m A:
dene	d e $ n e
vattne	" v a t $ n e
mäds	" m E: d s
namma	" n a $ m a
thegn	" t e: $ g n
lj	l j
äckit	e $ k I t
gomma	" " g U $ m a
chitt	" s' I t
jää	" j E:
soit	" s O j t
vavva	" " v A: v $ v a
jick	" j I k
ästa	E: $ s t a
dåjn	" d o: n
säta	" " s E: $ t a
maammaa	m a m $ m A:
båst	" " b O s t
pake	p a $ k e
tsåna	" t s o: $ n a
inneä	" " I $ n e $ % E:
sruva	s r }: $ v a
choppa	" s' O $ p a
busit	" b I $ s t
let	" l e:
dubbeknut	" d u0 $ b e $ % k n }: t
håja	" h o: $ j a
bun	" b }: n
tju	" s' }:
thälla	" " t e: $ % h e $ l a
cheda	" " x\ e: $ d a
pensen	" p e n $ s e n
sättax	" " s e $ t a k s
bälling	" " b e $ l I N
bruggan	" b r u0 $ g a n
brytet	" " b r y: $ t e t
skru	" s k r }:
särnan	" " s E: $ n` a n
bs	b s
igekott	" " i: $ g e $ k U t
thlänni	t $ % l` e $ n I
tyttaa	t Y $ " t A:
nenna	" " n e $ n a
mest	" m e: s t
sarta	" s a $ t` a
sma	" s m a
ämp	e m p
tölla	" t 9 $ l a
sku	" s k u0
mpa	e m $ p e: $ " A:
lalli	" " l a $ l I
tryckuppglass	" " t r Y k $ u0 p $ % g l a s
fli	" f l i:
vithund	" " v i: t $ % h u0 n d
sappa	" s a $ p a
håde	" h o: $ d e
fågen	" " f o: $ g e n
sål	" s o: l
köttbullana	" " s' 9 t $ % b u0 $ l a $ n a
neng	n e N
ådri	" " o: $ d r I
hessa	" " h e $ s a
hun	" h }: n
klappax	" " k l a p $ % a k s
facke	" f a $ k e
thlickan	t $ l I $ k a n
stån	" s t o: n
backaax	" " b a $ k a $ % a k s
råkax	" " r o: $ k a k s
gåbbe	" g O $ b e
kjufs	" " s' }: f s
taj	" " t a j
slätax	" " s l E: t $ % a k s
båkax	" " b o: $ k a k s
krone	" " k r u: $ n e
toppel	" " t O p $ e l
sönnä	" " s 9 $ n E:
lämnax	" " l e m $ n a k s
glal	" g l A: l
aff	a $ " f
lultomte	" " l }: l $ % t O m $ t e
gåssa	" g O $ s a
naaj	" n A: j
skojax	" " s k O j $ % a k s
pålvik	" " p o: l $ % v i: k
läggt	" " l e g $ t
ägga	e $ g a
sla	" s l a
fotsvetta	" " f u: t $ % s v e $ t a
op	" " u: p
kja	" s'
mah	" m A:
thenna	t e $ n a
tjåna	" s' o: $ n a
hamnax	" " h a m n $ % a k s
plygplan	" p l y: g $ % p l A: n
sötta	" s 9 $ t a
bäbe	" b E: $ b e
äcke	e $ k e
lassbil	" " l a s $ % b i: l
hex	h e k s
lalles	" " l a $ l e s
benena	b e $ n e $ n a
hitte	" h I $ t e
attebom	" " a $ t e $ % b U m
däffö	" d e f $ 2:
grävgopa	" " g r E: v $ g u: $ p a
lått	" " l O t
föle	" f 2: $ l e
cheja	x\ e $ j a
biin	" " b i: $ % i: n
nes	n e s
snu	" " s n }:
noo	" n u:
ets	" " e t s
sånne	" s O $ n e
neje	" n e $ j e
fle	f l e
tsamma	t $ " s a $ m a
gann	" g a n
köt	" k 2: t
hambala	h a m $ " b A: $ l a
kåssax	" " k o: s $ % s a k s
kläj	" k l e j
dub	" " d u0 b
sge	e s $ g e
gasga	" " g A: s $ g a
aach	" a $ x\
attades	a $ t a $ d e s
byggö	" " b Y g $ % 2:
bärbisä	" " b E: r $ % b I $ s E
ähähä	e $ h e $ h E
vågoulla	" " v o: $ g U $ % u0 $ l a
söliset	" " s 2: $ l I $ s e t
håssa	h O $ s a
lylafton	l Y $ " l a f $ t O n
dåje	" " d o: $ % j e:
stanns	" " s t a n s
möka	" " m 2: $ k a
bufbö	b u0 $ " " b 9
madl	" " m A: $ d e l
snää	" s n E:
tjove	" " s' u: $ v e
igem	I $ " g e: m
ekobaj	" " e: $ k U $ b a j
barbihästanas	b a r $ b I $ " h e $ s t a $ n a s
näka	" n E: $ k a
thrya	" t r Y $ a
miing	" " m i: $ I N
egi	e $ " g i:
daads	" d A: d s
räcebilan	r e $ " " s e: $ b I $ l a n
josefi	j U $ s e $ " f i:
tårtaa	" " t o: t` $ t A:
mumbrö	" m u0 m $ b r 2:
jeaj	x\ a j
givhe	" " j i: v $ h e
ääön	E: 2: n
thode	" " t u: $ d e
råtte	" " r O $ t e
puuss	" p u: s
lossax	" " l O s $ % s a k s
möcka	" m 9 $ k a
öåda	" " 2: $ o: $ d a
poä	" p a E
sie	" s i:
chts	k t s
mään	" m E:
lemlax	" " l e m $ % l a k s
huskulles	h u0 $ " " s k u0 $ l e s
kådel	" " k o: $ d e l
håndas	" " h o: n $ d a s
slogt	" s l u: g t
pontaerar	p O n $ " t e j e: $ r a r
hoppgunga	" " h O p $ % g u0 N $ a
honn	h O $ " n
syklat	s Y $ k l a t
lingsinget	" " l I N $ % s I N $ e t
ästä	e $ E
fiilt	f I $ " " i: l t
schkana	s` $ % k A: $ n a
niä	n I $ " E:
lommona	" " l U $ m U $ n a
lorig	" l o: $ r I g
skosten	" " s k u: $ % s t e: n
mög	" m 2: g
berjä	" " b E: r $ j E
törre	" " t 9 $ r e
gråon	" " g r o: $ % u: n
detgan	d e t $ g a n
ein	" e j n
åhaha	" " o: $ h a $ " h A:
soms	" s o: m s
intö	" " I n $ % t 2:
tee	" t i:
chiamo	k I $ " " a $ m U
häthana	" " h e t A: $ n a
nikl	" n I $ k l }: $ " s i: $ v e
båder	" " b o: $ d e r
sitfott	" s i: t $ f O t
mämmä	" m e $ m E
nallå	" " n a l $ l o:
pf	" " p e: $ % e f
michvå	" m I $ s` v o:
ööga	" " 2: $ 2: $ g a
glänte	" " g l e n $ t e
mackafär	m a $ k a $ " f E: r
fingefärg	" " f I N $ e $ % f e r j
äbi	" E: $ b I
vss	" " v e: $ e s $ " e s
säävl	" s E: v l
ktjaffe	k o: $ % s' a $ f e
sockodile	" " s O $ k U $ % d i: $ l e
glotsa	g l U t $ s a
tjingal	" s' I N $ g a l
lampena	l a m $ " p e $ n a
ijen	I $ j e n
nnehe	" " e n $ e n $ e
klåka	" " k l o: $ k a
gåmgåmma	" " g o: $ % m j O $ m a
tsenna	" " t s e $ n a
orra	" " O $ r a
gösselstacken	" " j 9 $ s e l $ % s t a $ k e n
thetha	" " t e: $ t a
dukax	d u0 $ " k a k s
jaiangje	j a $ I $ " a N $ j e
leksake	" " l e: k $ % s A: $ k e
pytta	" " p Y $ t a
trattorerna	t r a $ t O $ r e $ n` a
chö	" x\ 2:
båcke	" " b O $ k e
chna	s` n` a
brat	" " b r a t
tjäkje	" s' E: k $ j e
mockcykla	" m O k $ s Y $ k l a
pammi	" p a $ m I
kaffetopp	" " k a $ f e $ % t O p
däir	" " d E: $ I r
messmö	" " m e: s $ % s m 2:
tänänd	" " t e $ n e n d
jipän	" j I $ " e n
disi	" " d i: $ s I
tekä	" " t e: $ % s' E:
hchäjo	h x\ e $ j O
allana	a $ " " l A: $ n a
papijettet	p a $ p I $ " x\ e $ t e t
dannan	" " d a $ n a n
nangen	" n a N $ e n
åppa	O $ p a
diuj	d I $ " u0 j
hii	" h I
åll	O l
mänsa	" " m e n $ s a
vastare	" v a $ s t a $ r e
puppö	" " p u0 p $ % 2:
betta	" " b e $ t a
böax	b 9 $ % a k s
fygpanet	" f y: g $ p a $ n e t
kaff	k a f
fökaar	" " f 2: $ k A: r
håppa	" h o: $ p a
cyslax	s Y $ " s l a k s
mysjen	" " m y: s $ % j e: n
badjummet	" " b A: d $ % j u0 $ m e t
läbst	" " l e $ s t
farf	f A: r f
daoka	d a $ " o: $ k a
uk	" " }: $ k o:
ndbin	n $ % b i: n
spru	" " s p r u0
hndaa	h o: $ e n $ " d A:
mäi	m e $ " i:
njah	" " n j a
hihi	h o: $ i: $ " " h o: $ % i:
glölampan	" g l 2: $ % l a m $ p a n
blålade	" " b l o: $ l a $ d e
äve	" E: $ v e
mjn	" m j n
tjick	" s' I k
maha	m a $ " h A:
tåge	" t o: $ g e
lingfinget	" " l I N $ % f I N $ e t
snappt	" " s n a p t
läksk	" l E: k s k
täsa	" t E: $ s a
gopan	g U $ " p A: n
ågat	" " o: $ g a t
ponnierna	" " p O $ n I $ e $ n` a
bambilar	b a m $ " b i: $ l a r
tankräm	t a N $ % k r E: m
huckaluskan	" " h u0 $ " k A: $ l u0 $ s k a n
jaaha	" j A: $ h a
beätta	" " b e: $ % e $ t a
juvtompe	" j }: f t O m $ p e
räddisen	" " r e d $ % i: $ s e n
thöst	" " t 2: s t
nämä	n e $ m E
edd	" e d
efant	e $ " f a n t
biss	" " b I s
tjådde	" s' O $ d e
dumpes	" " d u0 m $ p e s
manget	" " m a N $ e t
bemme	b e $ m e
äich	e j s`
helikopteren	h e $ l I $ " " k O p $ t e r $ e n
gvillda	g e: $ v I l $ d a
bårde	" " b o: $ d` e
däsåbdasåv	" " d E: s O b $ d a $ s O $ " v e:
killax	" " k I $ l a k s
dinosauriena	d I $ n U $ " s a*U $ r I $ e $ n a
srölul	s r 9 $ " l }: l
hämmaldt	" " h e $ m a l t
ståe	" " s t o: $ e
lekja	" " l e: k $ j a
kåke	" k o: $ k e
såvna	" s o: v $ n a
tututututuut	" t u: $ t U t u: $ t U t u: $ t
meme	" m e m
vråa	" " v r o: $ a
onke	" O N $ k e
dåa	" " d o: $ a
duss	" " d u0 s
ky	" k Y
sss	e s $ e s $ " e s
smygys	" " s m Y $ g Y s
mårn	" m o: n`
tååt	" t o: t
gängeking	" j e N $ e $ k I N
kainen	" k a j $ n e n
chötax	" x\ 2: $ t a k s
föttorna	" f 9 $ t U $ n` a
nöö	" n 2:
vie	" v I
skördetrössar	" " x\ 2: $ d` e $ % t r 9 $ s a r
kryker	" " k r y: $ k e r
kiäte	s' I $ " E: $ t e
fågeläggnet	" " f o: $ g e l $ % e $ g n e: t
brr	b e: $ e r $ " e r
dopta	" " d u: p $ t a
gullpenga	" " g u0 l $ % p e N $ a
tokekopekikapopekapopeka	t u: $ k e $ k U $ p e $ " s' i: $ k a $ p U $ p e $ " " k A: $ p U $ % p e: $ k a
döff	" " d 2: $ % f
varfö	" v A: r $ f 9
recebilen	r e $ s e $ % b i: $ l e n
hånspået	" " h o: n $ % s p o: $ e t
göit	j 9 $ " i: t
oje	" O $ j e
klätta	" " k l e $ t a
kejet	" k e $ j e t
tjånt	" s' O n t
hermas	" " h e r $ m a s
tjä	" s' E:
deja	" " d e $ j a
dlmommo	" " d e: $ e l $ " m O $ m U
fakti	" f a k $ t I
åätt	" " o: $ % e t
tornää	t U $ " n` E:
dåka	" " d o: $ k a
jatt	" j a t
låssasugn	" " l O $ s a s $ % u0 N n
bage	b A: $ g e
näilj	" " n e $ % I l j
papådä	p a $ " " p O $ E
fåthen	" " f o: $ t e n
tsääng	" t s E: $ % e N
huchet	" " h u0 $ s` e t
digge	" " d I $ g e
ilick	" " i: $ l I k
gjäset	" " g l E: $ s e t
regneke	" " r e N n $ % e: $ k e
grävkopa	" " g r E: v $ k u: $ p a
kakake	k a $ k a $ k e
pdå	p e: $ d O
bromkruka	" " b r o: m $ % k r }: $ k a
mamada	m a $ " " m A: $ d a
sönders	" " s 9 n $ d e s`
mölkcham	" " m 9 l k $ x\ a m
omt	" O m t
allese	a $ l e $ " s e:
öppena	9 $ p e $ n a
funge	" " f u0 N $ e
provax	" " p r u: v $ % a k s
dänna	" " d e $ n a
nette	" n e t
tsänagn	" t s e $ n a N n
lilia	" l I $ l I $ a
ejla	" " e j $ l a
kladdtjejen	" " k l a d $ % s' e $ j e n
ovv	" " u: $ v e: $ " v e:
panien	" p A: $ n I $ e n
gögga	" " j 9 $ g a
ciila	" s i: $ l a
drättehögt	" " d r e $ t e $ % h 9 k t
gååt	" g o: t
kackaå	" " k a $ k a $ % o:
dassa	" " d a $ s a
tanbosten	t a n $ b u: $ s t e n
ibabik	I $ " " b a b $ " i: k
saav	" s A: $ v e
bvdebrm	b e $ v e $ " d e: $ b r m
faffa	" f a $ f a
nengäj	" " n e: $ % n j e j
kme	k o: $ m e
suksäkta	" " s }: k s $ % e k $ t a
såva	" " s o: $ v a
överrasknag	" " 2: $ v e $ % r a s $ k n a g
batt	" b a t
tubbithä	" " t u0 $ b I $ t E
vaä	" v e E
popcå	" " p O p $ % s o:
mackona	" " m a $ k U $ n a
kocke	" k O $ k e
vattn	" " v a t $ % n
hna	h o: $ n a
hungä	" " h u0 N $ g E:
addi	a $ d I
nainkave	n a $ I N $ % k A: $ v e
geke	" " j e: $ k e
tallri	" " t a l $ r I
mössena	" m 9 $ s e $ n a
åtsda	o: d s $ d a
kickin	" " k I $ k I n
ilsempel	" " I l $ s e m $ p e l
fjåo	" f j o: $ U
trosena	" " t r u: s $ e $ n a
chåkeboj	" s' o: k $ b O j
eppsa	e p $ s a
kompi	k O m $ p I
butana	b }: $ " t A: $ n a
strumpona	" " s t r u0 m $ p U $ n a
gyckaa	j Y $ % k A:
gungena	" " g u0 n $ % j e: $ n a
tanborstar	t a N $ % b O $ s` t` a r
ponniea	p U $ " n j e: $ a
faktit	f a k $ " t i: t
dablan	d a $ " b l a n
dädä	" " d E: $ d E
jihåg	d j I $ " h o: g
eldax	" " e l d $ % a k s
geget	" " g e: $ g e t
stinsa	" " s t I n $ s a
nginge	" n j I N $ e
thullar	t u0 $ l a r
mokcyklän	" m u: k $ s Y $ k l E: n
velling	" " v e $ l I N
kägga	" k e $ g a
bucken	" " b u0 $ k e n
brannbilar	" b r a n $ % b i: $ l a r
råtjud	" " r o: $ % s' }: d
slute	" " s l }: $ t e
busitha	" " b }: $ s I $ t a
kukevekuk	" k }: $ k e $ v e: $ k U k
did	" d I d
sjukhut	" " x\ }: k $ h }: t
thöcka	t 9 $ k a
nycklen	" " n Y $ k l e n
pluppar	" " p l u0 $ p a r
ämma	e $ m a
parka	" p a r $ k a
liss	" " l I s
flyte	" f l y: $ t e
såsamman	" " s o: $ s a $ m a n
gäcke	" j e $ k e
liggde	" " l I g $ d e
våller	" " v O $ l e r
mokslyklä	" m u: k s $ l Y $ % k l E:
killasysse	" " k I $ l a $ s Y $ s e
skrä	" " s k r E:
ops	" " u: p s
härst	" " h e s` t`
visaopf	" " v i: $ s a $ % O p f
nånes	" n O n s
bläddrax	" " b l e $ d r a k s
pumpax	" " p u0 m p $ % a k s
söda	s 2: $ d a
mde	" " e m $ d e
vpdä	v e: $ p e: $ " d E:
vånas	" " v o: $ n a s
lätterdum	" " l e $ t e $ % d` u0 m
martun	m a $ " t` }: n
jättethöta	" " j e $ t e $ % t 2: $ t a
tingni	" " t I N $ n I
thättetung	t e: $ h e $ t e $ % t u0 N
ogrä	" " u: $ g r E:
plöslit	" " p l 2: $ s l i: t
faft	" f a f t
igglar	" " I $ % g l a r
battenen	b a $ t e $ n e n
mmbrm	e m $ e m $ b e r m
lålä	" " l o: $ l E
majsam	" " m a j $ s a m
pickiäjn	" p I $ k I $ e $ j i: $ e n
påskäring	" " p o: $ % x\ E: $ r I N
tåj	" " t o: $ % j i:
mäfa	" m E: $ f a
kodja	" " k o: d $ j a
sopple	" " s O $ p e l
gjoddit	" j u: d $ d I t
dabi	d a $ " b i:
halla	" " h a $ l a
kjass	" s' a s
nangnana	" n a N $ n a $ n a
dygg	" d Y g
mitte	" " m I $ t e
kissegubbe	k I $ s e $ % g u0 $ b e
bael	" b E: l
ingejing	I N $ x\ e $ " j I N
intare	" " I n $ t a $ r e
påtse	" p o: d s
hisa	" " h i: $ s a
chyrka	s` Y r $ k a
edepant	" " e: $ d e $ p a n t
räcerbil	r e $ s e r $ % b i: l
pompom	p O m $ " p O m
kiksegångkinke	" " k I $ s e $ % g O N $ s' I N $ k e
bäga	" " b E: $ g a
fladdermu	" " f l a $ d e r $ m }:
nänga	" n e N $ a
gubbenn	" " g u0 $ b e n
hemen	h e $ m e n
eth	" e t
kolbuss	" " k o: l $ % b u0 s
nennee	" " n e $ n e $ e
thth	t t
sälje	" " s e l $ j e
ennan	" e $ n a n
tolj	" t O l j
åtsta	o: t $ % s t a
bamspelare	b a m $ % s p e: $ l a $ r e
puamma	p u0 $ " a $ m a
bäti	" " b E: $ t I
åei	O a j
regnrå	" " r e N n $ % r o:
itha	i: $ t a
snila	" " s n I $ l a
kktj	" k s'
hhn	h n
kompise	" " k O m $ p I s
brön	" b r 9 n
dungax	" " d u0 N $ % a k s
kannabins	" k a $ n a $ " b i: n s
titum	" t i: $ t u0 m
mock	" m O k
lelela	l e $ " l e: $ l a
gådan	" " g o: $ d a n
mökchla	" m 2: k $ k l a
likit	l I $ " k i: t
ngää	e n $ " g E:
klossa	" " k l O $ s a
tufftackde	" t u0 f t a k $ d e
lampasjyd	l a m $ " p A: s` y: d
gägä	" j E: g E:
namina	" n A: $ m I $ n a
ua	}: $ a
ahaha	" a $ h a $ " h A:
elje	" " e l $ j e
dera	" " d e: $ r a
ompa	" " O m $ p a
dålltjett	" " d o: l t $ j e t
gucka	" " g u0 $ k a
farnundet	f A: r $ " n u0 n $ d e t
påpp	" " p o: $ p e: $ " p e:
aets	a $ e t s
tavl	" " t A: v $ l
mant	m a n t
donka	" " d O N $ k a
kackan	" " k a $ k a n
hover	h o: $ v e r
jav	j a $ " v e:
söther	" " s 2: $ t e r
choklatomtar	x\ U $ " k l A: $ % t O m $ t a r
läggan	" " l e $ g a n
tsånt	" t s O n t
lje	" l e
nins	" n i: n s
joj	" j O j
ledopajst	" " l e: $ d U $ % p a j s t
mnstä	" e m $ e n $ E
thatha	t a $ t a
dritta	" " d r I $ t a
båpa	" b o: $ p a
silmen	" s I l $ m e n
dade	d a $ d e
nååx	" n o: k s
lackstol	" " l a k $ % s t u: l
hööt	" h 2: t
natte	" n a $ t e
jatin	x\ a $ " t i: n
gannen	g a $ " n e n
ktåka	k t $ o: $ k a
kåpe	" " k o: $ p e
hjält	" j e l t
elfanten	" " e l $ f a n $ t e n
krå	" " k r o:
bchöden	b s` 2: $ d e n
upa	}: $ p e: $ " A:
tedäs	t e $ " d E: s
banba	" " b A: n $ b a
mangn	m a N $ " g n
famåt	" " f a m $ o: t
tudde	" t u0 $ d e
säon	" " s E: $ O n
navelei	" " n A: $ v e l $ e: $ i:
etst	" " e t s t
höje	" " h 9 $ j e
empsam	" " e m p $ % s a m
uppnax	" " u0 p $ % n a k s
kjola	" " s' u: $ l a
dett	" d e t
plippe	" p l I $ p e
sea	" " s e: $ a
tihitta	t I $ h I $ t a
ång	" O N
puttralite	" " p u0 $ t r a $ l I $ % t e:
döla	" " d 2: $ l a
tåckax	" " t O k s $ % a k s
dofch	" " d O f t s'
sott	" s O t
ndaa	e n $ " d A:
desån	d e $ " " s o: n
toffler	" " t O $ f l e r
häb	" " h E: $ % b e:
bredje	" " b r e: d $ j e
springandes	" " s p r I N $ a n $ d e s
tsänga	" " t e: $ % s e N $ a
päila	" p e j $ l a
potfande	p O t $ f a n $ d e
bettona	" b e $ t U $ n a
ätip	" E: $ t I p
fankoglathä	" " f a N $ k U $ g l a t E:
äggk	e g $ k
välle	" v e $ l e
gd	g d
eboy	" e: $ b O j
eleton	e $ l e $ " t o: n
thlick	t $ l I k
nehähä	n e $ " h e $ h E
båsch	" " b O s`
ksäck	" " k o: $ % s` e k
opax	" " u: $ % p a k s
vänse	" " v e n $ s e
färän	f e $ " r E: n
tete	" " t e: $ t e
byggi	" " b Y g $ I
tjullät	s' u0 $ % l E: t
fyrkantia	" " f y: r $ % k a n $ t I $ a
ovöka	U $ " v 2: $ k a
bee	" b i:
juitas	j u0 $ " i: $ t a s
suddgum	" " s u0 d $ % g u0 m
rutschla	" " r u0 t` s` $ l a
hija	h I $ j a
dlni	d l $ n I
jemona	j e $ " " m o: $ n a
keckax	" k e $ k a k s
äpa	" E: $ p a
lyltomten	" l y: l $ % t O m $ t e n
dåbbåt	" " d o: b $ % b o: t
patta	" " p a $ t a
tland	" " t e: $ % l a n d
thyja	t Y $ j a
seum	" " s e: $ u0 m
kåssa	" k O $ s a
tjytt	" s' Y t
thällan	" " t E: $ l a n
poölen	p U $ % 2: $ l e n
henstej	" " h e: n $ % s t e j
sreis	s r e j s
nija	" n i: $ x\ a
sfäl	" s f E: l
hondmat	h O n d $ % m A: t
tjott	" s' O t
fågat	" " f o: $ g a t
kiseka	" " s' i: s $ % e: $ k a
kniben	" " k n i: $ % b e: n
schmuschla	" s` m u0 s` $ l a
hnhn	h n n
sramåt	s r A: m $ o: t
tsåthona	" t s o: t $ % h u: $ n a
mövl	m 9 $ " v l
dååj	" d o: j
hålj	" " h o: l $ j
kathathömma	k a $ t a $ " t 9 $ m a
pota	p O $ " t A:
gåckack	" " g O k $ a k
tjapax	" t s' a $ % a k s
flyttax	" " f l Y $ t a k s
fmå	f 9 r $ " m o:
starkase	" " s t a r $ k a $ s e
dåta	" " d o: $ t a
fickerna	" " f I $ k e $ n` a
fantekten	f a n $ " t e k $ t e n
nui	n }: $ " i:
fastnax	" " f a s t $ n a k s
bled	" b l e: d
maksana	" " m a k $ " s a $ n a
äme	" E: $ m e
ngenting	" n j e n $ t I N
åkeboj	" " o: $ k e $ b O j
trampetaktor	" " t r a m $ p e $ t a k $ t U r
sampse	" s a m p $ s e
dath	" d a t
ridbyxer	" " r i: d $ % b Y k $ s e r
bededande	b e $ " d e: $ d a n $ d e
jejas	j e $ j a s
kovv	" " k o: v $ % v e:
barbihästen	b a r $ b I $ % h e $ s t e n
itax	I $ " t a k s
mmmm	e m $ e m $ e m $ " e m
möppe	" m 9 $ p e
tippax	" " t I p $ % a k s
jis	" j I s
duja	d u0 $ j a
jarta	" " j A: $ t` a
göör	" j 2: r
kommere	k O $ " m e: $ r e
gösj	" " j 9 s`
eik	" e j k
taja	" " t a $ j a
sejt	" s e j t
ackak	a $ " k A: k
siåa	s I $ " " o: $ a
selv	s e l $ " v e:
sef	" " s e: $ % e f
mnjick	e m $ n j I k
odi	U $ " d i:
maddi	" " m A: d $ d I
fånela	" " f o: $ n e $ l a
daang	d a $ " a N
mammama	" " m a $ m a $ m a
farbo	" " f a r $ % b u:
thelesant	t e $ " l e $ " s a n t
tusenfoting	" " t }: $ s e n $ % f u: $ t I N
kattungana	" " k a t $ % u0 N $ a $ n a
stökit	" " s t 2: $ k I t
vidhust	" " v i: d $ h }: s t
dais	d a j s
åjba	O j $ b a
nähn	" " n E: n
jätt	" j e t
foklo	f U $ " k l o:
tjåjer	" s' o: $ j e r
litta	l I $ t a
tojta	" t O j $ t a
portä	p U $ " t` E:
jiffa	" j I $ f a
påsskäring	" " p o: s $ % x\ E: $ r I N
fing	" f I N
dilä	d I $ l E
dlä	d e: $ l E
becke	" b e $ k e
allde	a l $ d e
kakona	k a $ k U $ n a
modia	" " m u: $ d I $ a
kenge	" s' e N $ e
oppfö	" " O p $ f 9
läjon	l e $ j O n
dålj	" " d o: j
kuku	" k u0 U
kydde	" k Y $ d e
uppnäppan	" " u0 p $ % n e $ p a n
köha	" k 2: a
ago	" " A: $ g U
villi	" " v I $ l I
jöj	" j 9 j
hingon	" " h I N $ g U n
sakena	" s A: $ k e $ n a
åså	o: $ s O
jökå	" " j 2: $ k o:
dmamma	d I $ " m a $ m a
sillet	" " s I $ l e t
kitan	" k I $ t a n
boon	" b u: n
ikadana	" i: $ k a $ " d A: $ n a
kakåka	" " k A: k $ % o: $ k a
tittae	" " t I $ t a $ e
gollet	g U $ l e t
niässe	n I $ e $ s e
pajkax	" " p a j $ % k a k s
stannax	" " s t a $ n a k s
passgobbar	" " p a s $ % g O $ b a r
magje	m a $ " j e
kond	" k O n d
häslax	" " h e s $ % l a k s
lockit	" " l O $ k I t
lanlax	l a n $ " l a k s
sällaren	" " s e $ l a $ r e n
buck	" b u0 k
chäst	" " s e: $ % h e s t
tännena	" " t e $ n e $ n a
lamlar	" " l a m $ l a r
frammi	" " f r a $ m I
höttä	" " h 9 $ t E
ähå	e h o:
sni	" " s n I
kse	k o: $ e s $ " e:
hanine	" h a $ n I n
gallo	" " g a $ l U
täde	" t E: $ d e
emammam	e $ " m a $ " m A: m
hakupo	" h a $ k U $ p U
ässina	e $ s I $ n a
lassilen	" l a $ s I $ l e n
ippi	I $ p I
tannbåste	t a $ " n $ b o: $ s t e
dlång	" " d e: $ % l O N
ringvält	" " r I N $ % v e l t
gevis	j e $ " v i: s
thegnat	" " t e: $ g n a t
gjott	" j U t
skottis	" " s k O t $ t I s
hovov	h U $ " v O v
hauf	" h a*U f
badbos	" " b A: d $ % b u: s
plasse	" " p l a $ s e
tådådå	" " t o: $ % d o: $ d O
tebak	t e $ " b A: k
kjocka	" s' O $ k a
mäö	" " m E: $ % 2:
jöa	" " j 2: $ a
elefaant	e $ l e $ f a $ % a n t
jiikö	" j I $ k 2:
serbo	s e r $ b U
buta	b }: $ t a
klojs	" k l O j s
flätax	" " f l E: $ t a k s
taninen	" " t A: $ n I $ n e n
båra	" " b o: $ r a
fytha	" " f y: $ t a
hevö	h e $ " v 2:
bääbä	" " b E: $ b E:
chinge	" s` I N $ e
srä	s r E
havva	" " h A: v $ v a
nhnek	e n $ h o: $ " " n e: k
tallax	" " t A: l $ % l a k s
dossila	d O $ s I $ l a
hämtaa	" " h e m $ t a $ a
hamm	h a m
pönki	" p 9 N $ k I
hande	" h a n $ d e
snujja	" " s n u0 $ j a
enk	e N $ " k o:
äse	E: $ s e
sflickan	" " e s $ % f l I $ k a n
thättemåa	t e: $ h e $ t e $ % m o: $ a
chischo	x\ I $ s` U
sriva	s r i: $ v a
bantebop	b a n t $ " " e: $ b O p
dadan	d a $ d a n
ran	r a n
buder	" b }: $ d e r
ådet	" " o: $ d e t
gjore	" j u: r
chånn	" s' O n
blila	" " b l i: $ l a
öopp	" " 2: $ " O p
hällej	" " h e $ l e j
gåst	" g o: s t
tjuuv	" s' }: $ v
sranden	" " e s $ % r a n $ d e n
läanle	" " l E: $ a n $ l e
binboet	" b i: n $ % b u: $ e t
thobbit	" t O $ b I t
däus	" " d E: $ u0 s
bekslasj	" b e: k $ s l A: s`
sprickena	" " s p r I $ k e $ n a
ridbyxe	" " r i: d $ % b Y k $ s e
dåv	" " d o: $ v e
blite	" " b l i: $ t e
vadax	" " v A: d $ % a k s
relefant	r e $ l e $ " f a n t
hönaa	" " h 2: $ % n A:
ndö	e n $ % d 2:
utte	" " u0 $ t e
mjoo	" m j u:
gifter	" " j I f $ t e r
kjåpax	" " s' o: p $ % a k s
föön	" f 2: n
nun	" " n }: n
nallena	" " n a $ l e $ n a
taffe	" " t a $ f e
därs	d E: s`
lten	e l $ t e n
gikast	" " g i: $ k a s t
drånga	" d r O N $ a
beibis	b e $ " i: $ b I s
töcke	" t 9 $ k e
kva	" " k v a
sävla	" " s E: v $ l a
fåkeboj	" f o: $ k e $ b O j
gbin	j 9 $ t e $ " b i: n
bäx	" b e k s
ponni	" " p O $ n I
buggi	" " b u0 $ g I
mj	" m j
möönt	" m 2: n t
lallis	" " l a $ l I s
kjebba	" " s' e $ b a
spricke	" " s p r I $ k e
lassilä	" l a $ s I $ l E
brummax	" " b r u0 $ m a k s
passifant	p a $ s I $ " f a n t
hånnis	" " h o: n $ % n i: s
okä	" " u: $ % s' E:
matesatip	m a t $ % s a $ t I p
takana	t a $ " k A: $ n a
brmmabina	b r $ " m A: $ b I $ n a
bäbin	" b E: $ b I n
grisana	" " g r i: s $ a $ n a
elleblund	" " e $ l e $ % b l u0 n d
ojui	" " u: $ % x\ Y $ " i:
äppele	e $ p e l
fed	" f e: d
renna	" " r e $ n a
badsakan	" " b A: d $ % s A: $ k a n
jygg	" j Y g
smojt	" s m O j t
bandasjet	" " b a n d $ a $ s` e t
bamseelefant	" " b a m $ s e $ e $ l e $ % f a n t
thättefott	t e: $ h e $ t e $ f O t
ahah	a $ " h A:
tsålit	" t s O $ " l i: t
lastbile	" " l a s t $ b i: l
jylla	" " j Y $ l a
ehehant	e $ h e $ " h a n t
spöt	" s p 2: t
prrrr	p r r
isbjörna	" " i: s $ % b j 2: $ n` a
kantse	" " k a n t $ % s e:
döö	" d 2:
gläklipparen	" " g l E: $ % k l I $ p a $ r e n
gullbyskläd	" " g u0 l $ b Y s $ k l E: d
tåne	" " t O $ n e
bös	" " b 9 s
gabba	" g a $ b a
aljia	a l $ " j i: $ a
dörrå	" " d 9 r $ % o:
blöde	" " b l 2: $ d e
koppela	" " k O $ p e l $ a
ura	}: $ r a
dajna	" " d a j $ n a
inedom	I $ n e $ " " d U m
därsp	" d E: r $ e s $ % p e:
näjeme	" n e j E: m
ehia	" e: i: $ a
äna	" E: $ n a
allså	" " a l $ s O
stövlen	s t 9 v $ " l e n
nilnå	n I l $ " n o:
kålla	" " k O $ l a
dotta	" " d O $ t a
måån	" m o: n
barbihästfilmarna	b a r $ b I $ " h e s t $ f I l $ m a $ n` a
asse	" a $ s e
ramme	" r a $ m e
guldpenga	" " g u0 l d $ % p e N $ a
ådl	" " o: $ d e l
hara	" " h A: $ r a
vjötha	" v j 2: $ t a
thot	" " t u: t
nänus	" " n E: $ n u0 s
ejej	e $ " " j e j
vämming	" v e $ m I N
jimma	" j I $ m a
cyrkos	s Y r $ k U s
met	" m e t
bride	" b r i: $ d e
uss	}: $ e s $ " e s
brandtraktorn	" " b r a n d $ % t r a k $ t U n`
srätta	s r e $ t a
haplappen	h a $ p l a $ p e n
fuffnucke	" f u0 $ f n u0 $ k e
diää	d I $ " E:
nika	" " n i: $ k a
mugglä	" " m u0 $ g l E:
thelefantena	t e $ l e $ % f a n $ t e $ n a
ääe	E: $ e
hajsen	" h a j $ s e n
åaa	O A:
pöppö	" p 9 $ p 2:
nedepastej	" n e: $ d e $ p a $ % s t e j
darmt	" d a r m t
rejelle	r e $ " j e l
tuppe	" t u0 $ p e
dansla	" " d a n s $ l a
buchi	" b U x\ I
ojch	O j $ t s'
fäta	" " f E: $ t a
kokodil	" k U $ k U $ " d i: l
pippilakan	" " p I $ p I $ % l A: $ k a n
hmö	" h u0 m 2:
naagn	n a $ " " a N n
vills	" v I l s
tjitt	" s' I t
musi	m }: $ " s i:
devang	d e $ " " v a N
hybat	h Y $ " b A: t
ämpax	e m p $ % a k s
vaamt	" v a m t
hupp	" h u0 p
thila	t I $ l a
bapan	b a $ " p A: n
pjepa	" p j e $ p a
ägä	E: g E:
näms	" n e m s
bäre	" b E: $ r e
systar	" " s Y $ s t a r
thingana	" " t I N $ g a $ n a
dapp	" d a p
kikseånkunke	" " k I s $ o: N $ k u0 N $ k e
hållde	" " h O l $ d e
ånd	O t
dapa	d A: $ p a
cånfleks	k o: n $ f l e: k s
singrar	" s I N $ r a r
nomemä	n O $ m e $ m E
synna	" s Y $ n a
nennå	n e $ " n o:
fita	" " f I $ t a
china	" " s' i: $ n a
dne	" d n
tjänne	" s' e $ n e
äör	2: r
tåv	" t o: v
fea	" " f e: $ a
blölla	" " b l 9 $ l a
fegg	" f e: g
dadde	" " d a $ d e
klasdiä	" " k l A: s $ d I $ % E:
rolia	" " r u: $ l I $ a
djuj	" j u0 j
vt	" f t
thärar	" " t E: $ r a r
däas	" " d E: $ a s
hanges	" h a N $ e s
skopp	" " s k O p
glasköge	" " g l A: s $ % x\ 2: $ g e
saass	" s A: s
tomteböcker	" " t O m $ t e $ % b 9 $ k e r
hojkar	" h O j $ k a r
boe	" b u: $ e
gaga	" " g A: $ g a
tunde	" " t u0 n $ d e
plåst	" " p l o: s t
startax	" " s t A: t` $ a k s
ötha	" " 2: $ t a
ksett	k $ " s e t
heemn	" h e: $ m n
sycke	" s Y $ k e
haits	h a $ " i: t s
kladdiä	" " k l a $ d I E
näö	" " n e $ % 2:
pocken	" " p O $ k e n
mänso	" " m e n $ s U
ridan	" " r i: $ d a n
nka	e N $ k a
vaisen	" v a j $ s e n
ackax	a $ " k a k s
srattar	s r a $ t a r
desti	d e $ s t I
sjåx	" x\ o: k s
päss	" p e s
babidocker	b a $ b I $ " " d O $ k e r
gaat	" g o: t
lörda	" l 2: $ d` A: g
binin	b I $ " n i: n
sputa	" s p }: $ t a
tapering	t a $ " p e: $ r I N
hittut	" " h I $ % t }: t
jang	j a N
gumpers	" g u0 m $ p e s`
pöbe	" " p 2: $ b e
såter	" s o: $ t e r
dakta	d a k $ t a
seba	" " s e: $ b a
kjippa	" " s' I $ p a
söött	" s 2: t
gasslana	" " g a $ % s l a $ n a
låsass	" " l o: s $ a s
benu	" " b e: $ n u0
xxxbilen	" e k $ s k s $ % b i: $ l e n
jåbbaj	" j O $ b a j
kuls	" " k }: l s
miiin	" m i: i: n
linv	l I n $ " v e:
glåna	" " g l o: $ n a
röma	" r 2: $ m a
tattå	" " t a $ t o:
messör	m e $ " " s 2: r
gön	" j 2: n
pså	" " s o:
flugsvapana	" " f l }: g $ s v a $ p a $ n a
dsävasin	d s` E: $ v a $ " s i: n
fåga	" " f o: $ g a
gunbr	" g u0 n $ b r }: $ " A: $ r I
aum	" a*U m
kattmamma	" " k a t $ % m a $ m a
tanemel	t a $ " " n e: $ m e l
pmö	p e: $ e m $ % 2:
ådvå	" " o: $ d v o:
klämmad	" " k l e $ m a d
visax	" " v i: s $ % a k s
äma	" E: $ m a
dnf	d e: $ e n $ " e f
mose	" " m u: $ s e
fapos	" f A: $ p U s
tjans	" s' a n s
sytte	" s Y $ t e
möe	" " m 2: $ e
oao	u: $ A: $ " u:
oita	" " O j $ t a
hh	h
pyta	" p y: $ t a
bebibibe	" b E: $ b I $ b I $ b e
thättesint	t e: $ h e $ t e $ % s I n t
itattatt	I $ t a $ " t a t
hovepå	" " h u: $ v e $ % p o:
puffår	" " p u0 f $ % o: r
thladdat	t $ l a $ d a t
gl	" g l
sepela	s e $ p e $ l a
änni	e $ n I
duddä	" d u0 $ d E
jottifem	" j O $ t I $ " f e m
höppe	" h 9 $ p e
putteliten	p u0 $ t e $ " l i: $ t e n
guilas	" g i: $ l a s
hönitut	" h 2: $ n I t $ }: t
srubbe	s r }: $ b e
tåckom	" " t O $ k O m
täär	" t e E: r
chöchtaa	x\ 9 $ x\ $ t a $ a
skatat	" " s k A: $ t a t
biäcke	" " b i: $ % e $ k e
ööj	9 j
kölle	" " s' 9 $ l e
connei	k O $ " n e j
chej	x\ e j
kuve	k }: $ v e
grävgopan	" " g r E: v $ g U $ p a n
semp	" s e m p
dåp	" d o: p
dluffe	d e $ s I $ " l u0 $ f e
bellää	b e $ " l E:
tåk	" t o: k
kotä	k O t E
gangja	" g a N $ % j A:
kra	" k r a
psa	s a
somman	" " s O $ m a n
bambila	b a m $ " b i: $ l a
bäbiskriskor	" b E: $ b I $ s k r I $ s k U r
sycker	" s Y $ k e r
ringena	" " r I N $ e $ n a
ettemycke	" e $ t e $ % m Y $ k e
släckan	" " s l e $ k a n
römat	" r 2: $ m a t
motcykel	" " m u: t $ % s y: $ k e l
siisk	s I $ I s k
jinna	" j I $ n a
båba	" b o: $ b a
kmajo	k $ m a $ j U
smutset	" s m u0 t $ s e t
öpm	" " 2: $ p e: $ " e m
nappe	" n a $ p e
böppa	" b 9 $ p a
nalljan	" n a l $ j a n
äljaa	" e l $ j A:
jålla	" j O $ l a
kamax	" " k a m $ % a k s
ecken	" " e $ k e n
thäggen	" " t e: $ % h e $ g e n
gaggax	" " g a $ g a k s
hammarenä	" " h a $ m a r $ a n E:
stoo	" s t u:
låång	" " l o: $ % O N
siettao	s I $ " " e $ t a $ U
svarax	" " s v A: $ r a k s
åne	" " o: $ n e
jåoä	" j O E
bippi	" b I $ p I
dt	d e: $ t e:
kächle	" " s' e $ l e
smp	" s m p
aits	a $ " i: t s
semme	" s a m
ifante	I $ " f a n $ t e
uffå	" u0 f $ % o:
chunger	" s' U N $ e r
tasik	t a $ " s i: k
essee	e $ " s i:
bysche	b Y $ s`
suklingar	" s }: $ k l I N $ a r
fua	f }: $ a
äsa	E: $ s a
tänknte	" " t e N k $ n t
tjoja	" s' O $ j a
katto	" " k a $ t U
mymla	" m Y m $ l a
efanten	e $ " f a n $ t e n
mmojbå	m I $ l I $ " m O j $ b o:
jöt	" " j 2: t
muchet	" m U t $ s' e t
batte	b a $ t e
farbon	" " f A: r $ % b u: n
lillet	" " l I $ l e t
nall	" n a l
mammat	" " m a $ m a t
sjörövarlapp	" " x\ 2: $ r 2: $ v a r $ % l` a p
buppaa	" b u0 $ " p A:
flyge	" f l y: $ g e
appedos	a $ p e $ d U s
rötopp	" " r 2: $ % t O p
dratt	" d r a t
duktit	d u0 k $ " t i: t
däaaa	" d e o: $ a
sminksaker	" " s m I N k $ % s A: $ k e r
farpa	" " f a r $ p a
mnk	m N k
ega	" e: $ g a
jätteslora	" " j e $ t e $ % s l u: $ r a
fao	f a*U
pote	p U $ t e
kritta	" k r I $ t a
putteluskan	p u0 $ t e $ " l u0 $ s k a n
gichen	j I $ k e n
åp	o: p
alaa	a $ " l a
liisaa	" " l i: $ s a
krockaste	" " k r O $ k a $ s t e
bläj	" " b l e j
span	" s p a n
såvaskin	s o: $ " v a $ % x\ i: n
tsåån	" t s o: n
hamo	" h a $ m U
happax	" h e $ p a k s
dlaa	d e $ s I $ " l A:
gdgå	g d $ % g o:
tsrå	t s $ r o:
såo	s o: $ " u:
tjovle	" s' O v $ l e
pbacka	" " p e: $ % b a $ k a
keffå	" k e $ f o:
fsch	f s`
beke	b e $ k e
tågvangen	" " t o: g $ % v a N $ e n
lilba	l I l $ b a
plasser	" " p l a $ s e r
ämm	e m
golet	g U $ l e t
ais	" a j s
hårsnodd	" " h o: $ s` n` O d
däth	" d E: t
båtte	" " b o: t $ t e
thättesnäll	t e: $ h e $ t e $ % s n e l
elefante	e $ l e $ " f a n $ t e
våan	" " v o: $ a n
häskle	" " h e s $ k l e
bäjer	" " b e $ j e r
böjk	" " b 9 j $ % k o:
afs	" A: f s
köx	" k 9 k s
ledi	l e $ " d i:
appa	a $ p a
thäcketor	t e $ k e $ t O r
djåttax	" j O $ t a k s
gåre	" " g o: $ r e
kattena	" " k a $ t e $ n a
fölit	f 9 $ " l i: t
jooo	" j O u:
doktoväskan	d O k $ t U $ % v e $ s k a n
xa	k s a
hagbadet	" " h A: g $ % b A: $ d e t
växlax	" " v e k $ s l a k s
sonl	" " s o: $ n e l
emä	e $ m E
väss	v e s
pri	p r I
hama	" " h A: $ m a
gammi	" " g a $ m I
dockstol	" " d O k $ % s t u: l
låsx	" " l O k s
djella	" j e $ l a
glannaking	g l a $ " n A: $ k I N
bajta	" " b a j $ t a
fij	" f I $ d j e j
thåsa	" " t o: $ s a
håj	h o: $ " " j i:
tidn	" " t i: d s n
dennet	" " d e $ n e t
metjo	" " m e: t $ s' U
däda	" " d E: $ d a
eljg	e l $ " j g
gope	" g o: $ p e
ussat	" u0 $ s a t
svätta	" " s v e $ t a
hants	" " h A: n t s
neli	" n e $ l I
låse	" l o: $ s e
hathan	" h A: $ t a n
tint	t I n t
hundlapp	" " h u0 n d $ % l a p
häbbat	" h e $ b a t
srågax	s r o: g $ % a k s
körrathömma	" " s' 9 $ r a t 9 $ m a
lcha	l $ s` a
benbuvos	" " b e: n $ % b }: $ v U s
tjyang	" " s' y: $ " a N
leto	" " l e: $ t U
långfinget	" " l O N $ f I N $ e t
jukan	j }: $ k a n
ölallt	9 l a l t
thättelång	t e: $ h e $ t e $ % l O N
äb	e b
börnen	" b 2: $ n` e n
skantera	s k a n $ " t e: $ r a
blönen	" " b l 9 $ n e n
sedes	" " s e: $ d e s
tågel	" t o: $ g e l
åbbå	O $ b O
gätsa	" j e t $ s a
oöks	" " u: $ 2: k s
lylafson	l Y $ " l a f $ s O n
snods	" s n u: d s
tecka	" " t e $ k a
auch	a*U $ " s`
änt	" e n t
bollä	" " b O $ l E
badringa	" " b A: d $ % r I N $ a
thäcketo	t e $ k e $ t O
dockstolen	" " d O k $ % s t u: $ l e n
nätterolit	" " n e $ t e $ % r u: $ l I t
tylla	" t Y $ l a
fikå	f I $ " k o:
honnes	h O $ " n e s
lejonbarn	" " l e $ j O n $ % b A: n`
tompar	" " t U m $ % p A: r
möj	" " m 9 j
ansi	" " a n $ s I
böö	" b 2:
bussä	" " b u0 $ s E
chågel	" " s e: $ % h o: $ g e l
pesenten	p e $ " s e n $ t e n
ajt	" a j t
sittra	" " s I $ t r a
guffe	g u0 $ f e
latt	" l a t
tamfä	" " t a m $ % f E:
plaatt	p l a $ " " a t
stool	" s t u: l
tutut	" t u: $ t U
mölksar	" " m 9 l k $ s a r
musel	m u0 $ s e l
tratorer	t r a $ " t u: $ r e r
babygröt	" " b E: $ b I $ % g r 2: t
ganka	g a N $ k a
tälek	" " t e l e: k
makajone	m a $ k a $ " " j u: n
mchn	m a k n
tjårta	" s' o: $ t` a
öppap	9 $ p a p
nåej	" " n o: $ e j
åfa	" " o: $ f a
abby	a b $ b y:
aeh	a $ " E:
hästmatta	" " h e s t $ % m a $ t a
ävev	E: v e: v
sklinkata	s k l I N $ " k A: $ t a
kompstä	k O m $ " " p s t E
härm	" " h e r m
burrabu	" " b u0 $ r a $ b }:
bäsbifäre	" " b e s $ b i: $ % f E: $ r e
dajan	d a $ " j A: n
tefånet	" " t e: $ % f o: $ n e t
blyf	" b l y: f
hjääm	" j E: m
husyster	" " h }: $ % s Y $ s t e r
åtan	" " o: $ t a n
siökä	" " x\ 2: k E
bansammen	b a n $ " " s a $ m e n
baff	b a f
thicken	" " t I $ k e n
fjo	" " f j U
svii	" " s v I
vattene	" " v a $ t e n $ e
tsotte	" t s O $ t e
ojo	" " u: $ j O
sölde	" " s 9 l $ d e
köta	" " k 2: $ t a
gacha	" " g a $ s` a
fii	f I $ " i:
hndä	h r j E
gåki	" " g o: $ k I
bellapsånge	b e $ " l a p $ s O N $ e
dåss	" " d O s
gjordä	" " j u: $ d` E
glacka	" " g l a $ k a
bejä	" b e $ j E
matam	" m a $ t a m
srabba	s r a $ b a
toffä	" " t O $ % f E:
filmren	" " f I l m $ r e n
däla	" " d E: $ l a
läbs	" " l e $ s
ådån	O $ " d o: n
öönö	2: n 2:
gj	" j
körd	" s' 2: d`
reg	r e g
heemsk	" h e: $ m s k
sandibella	s a n $ d I $ " b e $ l a
ädula	" E: $ d }: $ l a
dötboll	" d 2: t $ b O l
peppakakena	" " p e $ p a $ k a $ k e $ n a
najda	" " n a j $ d a
jich	" j I t s'
mussa	m u0 $ s a
bocke	" " b O $ k e
jubbe	" j u0 $ b e
ngjau	" n e: j a*U
huskverekta	" " h }: s $ k v e $ r e k $ t a
lampsduker	" " l a m p s $ d }: $ k e r
råmpsam	" r o: m p $ % s a m
muppaa	" " m u0 $ p a
kliss	" k l I s
assigositis	a $ s I $ g U $ " s i: $ t I s
chall	" s' a l
gägax	" g e $ j a k s
motcyklar	" " m u: t $ % s Y $ k l a r
öffåff	9 $ f O f
sdangen	e s $ d e: $ " a N $ e n
papådäda	p a $ " " p O $ " d E: $ d a
nappfapsa	" " n a p $ % f a p $ s a
ånst	O n s t
köd	" s' 2: d
utetrakton	" " }: $ t e $ t r a k $ t U n
djååvl	" j o: v l
ähaa	E: A:
anana	" " a $ n a $ n a
glåmme	" " g l o: $ % m
pänn	" p e n
gloka	" " g l u: $ k a
viåcka	v I $ " O $ k a
hjuul	" " j }: l
däo	" " d E: $ U
hue	h u0 $ " e:
hetä	h e $ " t E:
dylt	d Y l t
helj	" h e l j
jooi	j U $ " " O j
nyckepiger	" " n Y $ k e $ % p i: $ g e r
lassbila	" l a s $ b I $ l a
tjåj	" s' O j
ammela	a $ m e $ l a
häman	" " h e n
depe	d e $ p e
ätan	" E: $ t a n
prödö	" " p r 2: $ % d 2:
toppax	" " t O p $ % a k s
äjaa	e $ j A:
fapas	" f A: $ p a s
kongis	k O $ n j I s
töjk	" " t 9 j $ % k o:
hästaä	" " h e s t $ % A: E
äsebej	E: s $ b e j
fakis	f a $ " k i: s
dompe	d U m $ p e
peded	p e $ " d e d
meö	m e $ % 2:
stenhått	" " s t e: n $ h O t
sogov	s O $ " g o: v
ög	2: g
muä	" m Y E
roldera	" " r O l $ d e $ r a
stjä	" " x\ E:
tjånni	" s' O $ n I
kockax	" " k O k $ % a k s
låssastäcket	" " l O $ s a s $ % t e $ k e t
öffa	9 $ f a
aransj	a $ " r a n` s`
krao	" k r a*U
kaffetoppe	" " k a $ f e $ % t O $ p e
bene	" " b e: $ n e
tvån	" t v o: n
tjuffan	s' u0 $ f a n
tömme	" t 9 $ m e
thättehått	t e: $ h e $ t e $ h O t
xxxkakana	" e k $ s k $ s k a $ k a $ n a
dasda	" d a s $ d a
väktus	" " v e k $ t u0 s
liklen	" " l i: k $ l e n
dila	d I $ l a
pinnene	" " p I $ n e $ n e
thinna	" t I $ n a
basjenödi	b a x\ e $ n 2: $ d I
pokel	" " p o: $ k e l
dake	" d e j k
momom	m U $ " m O m
fygå	" " f y: $ % g o:
sadden	s a $ d e n
flygpan	" " f l y: g $ p a n
våagar	" " v o: $ % A: $ g a r
draj	" d r a j
annikan	" a $ n I $ k a n
daatt	" d A: $ t
skjutitit	" " x\ }: $ t i: $ t I t
hisse	" h I $ s e
jea	x\ a
kommet	" " k O $ m e t
plyngplan	p l Y N $ % p l A: n
gåcki	" " g O k I
ini	" i: $ n I
ålle	O $ l e
gjost	" j U s t
miitt	m I $ I t
våssax	" v o: s $ % s a k s
klecke	k l e $ k e
jässa	" j e $ s a
ärsk	e s` k
dubblö	d u0 $ " b l 2:
mmon	m I $ l I $ " m u: n
hundla	" " h u0 n d $ l a
smycko	" " s m Y $ k U
kchönne	k x\ 9 $ n e
pönan	" p 2: $ n a n
äåe	o: $ e
nöcke	" n 9 $ k e
anine	a $ " " n i: n
gaberob	g a $ b e $ " r o: b
höno	" " h 2: $ n U
blan	b l a n
brööst	" b r 2: s t
memma	m e $ m a
roett	r U $ " e t
måa	" " m o: $ a
gafa	g a $ f a
blickax	" " b l I k $ % a k s
onasson	U $ " n a $ s U n
liskla	" " l I s $ k l a
addelin	a $ " d e $ " l i: n
bööst	" b 2: s t
pingret	" " p I N $ r e t
spadana	" " s p A: $ d a $ n a
ovoff	U $ " v O f
hondar	" " h O n $ d a r
tjolet	" s' o: $ l e t
vafupp	v a $ " f u0 p
bakesaten	b A: k $ " e $ " s A: $ t e n
hye	" " h y: $ e
kamareller	k a $ m a $ " r e $ l e r
ojkl	O j $ k l }: $ " s i: $ v e
sädig	" s e $ d I g
klåslapp	" k l o: s $ % l a p
sts	" s t s
säril	" s E: $ r I l
sabak	" " s A: $ b a k
fatist	f a $ " t I s t
gåckax	" " g O k $ % a k s
pum	" " p u0 m
storebrossan	" " s t u: $ r e $ b r O $ s a n
dåter	" " d o: $ t e r
seja	" " s e $ j a
uppi	" " u0 $ p I
sönt	" s 2: n t
fickch	" " f I k $ x\
kocket	" k O $ k e t
läddä	" l e $ d E
ijaa	I $ " j A:
thättehårt	t e: $ h e $ t e $ h o: t`
haatt	" h A: $ t
gockan	" g O $ k a n
tjimme	" s' I $ m e
kaje	" " k a $ j e
grani	g r a $ " n i:
täna	" t E: $ n a
najaj	" " n a $ j a j
gäke	" j E: $ k e
skruvmes	" " s k r }: v $ % m e: s
gopax	g U $ " p a k s
anners	" " a $ n e s`
dribäbi	" d r i: b E: $ b I
näähä	" n E: h E
tsång	" t s O N
one	" U $ a n
ånasson	O $ n a $ s O n
gåll	" g O l
ptn	p e: $ t e: $ " e n
säkelsbälle	" " s E: $ k e l s $ b e $ l e
höbala	" " h 2: $ % b A: $ l a
spricko	" " s p r I $ k U
näte	" n E: $ t e
aaha	" A: $ h a
brönen	" b r 9 $ n e n
mässe	" m e $ s e
barnvargar	" " b A: n` $ % v a r $ j a r
mämbö	" m e m $ b 2:
kiksekick	" " k I s $ k I k
rättehemsk	" " r e $ t e $ % h e m s k
deke	" " d e: $ k e
foke	" f u: $ k e
chlump	k l u0 m p
döe	" " d 2: $ e
sjockat	s` O $ k a t
stull	" " s t u0 l
tittaa	t I $ " t A:
oåda	" " u: $ % o: $ d a
sääjd	" s E: j d
vsch	v s`
åej	O e j
tm	" " t e: $ % e m
akfat	" " a k $ % f A: t
tjuffona	s' u0 $ f U $ n a
brevi	" b r e: $ v i:
ädne	" E: d $ n e
doppi	" " d O $ p I
nöcka	" n 9 $ k a
lämmat	" " l e $ m a t
ksanna	s' I $ l U $ " " s a $ n a
gäsklippa	" j e s $ % k l I $ p a
höa	" " h 2: $ a
gech	" g e k
geta	" " j e: $ t a
siin	" s i: n
parne	" " p A: $ n` e
glåben	" " g l o: $ % b e: n
mjm	" m j m
schpela	" s` $ p e $ l a
räcebillastbil	r e $ " " s e: $ b I $ l a s t $ % b i: l
mme	e m $ m e
rättis	" " r e $ t I s
våa	" " v o: $ a
delis	d e $ " l i: s
kååj	" k o: j
bässina	" " b e $ " " s i: $ n a
faboren	" " f A: $ % b o: $ r e n
bombe	" " b O m b $ e
mago	" " m A: $ g U
sååk	" " s o: $ % o: k
bafota	b a $ " " f u: $ t a
beti	" " b e: $ t I
klax	" k l a k s
sema	s e $ m a
fruk	" f r u0 k
ritti	" " r I $ t I
abbis	" a $ b I s
nejne	" " n e j $ n e
maskåland	" " m a s k $ o: $ % l a n d
thärra	" " t E: $ r a
ruttit	" " r u0 $ t I t
knib	" " k n i: $ % b e:
möh	" " m 2: $ % h o:
rax	" r a k s
jojelä	" " j O $ j e $ l E
tåäme	" " t o: $ % E: $ m e
hejax	" " h e $ j a k s
gida	" " g i: $ d a
trägård	" t r E: $ g o: d`
pfåbe	" f o: $ b e
granbu	" " g r A: n $ % b }:
mpel	e m $ p e l
ålan	" " o: $ l a n
såne	" " s o: $ n e
gungeligung	" " g u0 N $ e $ l i: $ g u0 N
traktorbil	" " t r a k $ t U r $ % b i: l
pappenpi	" " p a $ p e n $ p I
vattenkopper	" " v a $ t e n $ % k O $ p e r
jool	" j u: l
ådä	O $ E
asss	a $ " s e s
gådsda	" " g o: $ d e $ d a
äcebilen	s` $ % b i: $ l e n
dånan	" " d o: $ n a n
svad	" " s v A: d
miine	m I $ I n
baass	" b A: s
hjäpa	" j E: $ p a
hökä	" " h 2: k $ % E:
singet	" s I N $ e t
dk	d e: $ k o:
smultjon	" " s m }: t $ s' O N
bötta	" b 9 $ t a
ballongena	b a $ " l O N $ e $ n a
gubbana	" " g u0 b $ % b A: $ n a
dådla	" " d o: d $ l a
mutsira	" " m }: t $ % s i: $ r a
groga	" " g r u: $ g a
pagnen	" p a $ n j e n
jaes	" j A: s
sannen	" " s a $ n e n
chokla	x\ U $ " k l a
snigen	" " s n i: $ g e n
hocka	" " h O $ k a
blåsen	" b l o: $ s e n
hammo	" h a $ m O
dav	d a $ " v e:
mämä	" m e $ m E
eae	" 2:
gytlapp	" j y: t $ % l a p
ginging	" " j I N $ I N
hiit	h I $ " i: t
håff	" " h o: f
nannam	n a $ " n a m
älskax	" e l $ s k a k s
lajkititidänaj	" " l a j $ " k I $ t I $ t I $ d e $ n a j
äseberg	E: $ s e $ " b e r j
grävit	" " g r E: $ % v i: t
gubbae	" " g u0 b $ a j
vvovvar	v e: $ v U $ v a r
seröja	s e $ r 9 $ j a
rakapparara	" " r A: k $ a $ p a $ % r A: $ r a
nejna	" " n e j $ n a
böbä	b 9 $ " " b E:
ht	h o: $ t e:
äjaja	e $ j a $ j A:
gring	" " g r I N
gyngskolen	" " j Y N $ s k u: $ l e n
kåninens	" " k O $ n I $ n e n s
göönt	" j 2: n t
hahade	h a $ h a $ d e
namnamna	" " n a m $ % n a m $ n a
gakta	" g a k $ t a
annen	" " a $ n e n
agax	" " A: g $ % a k s
klata	k l A: $ t a
fötten	" f 9 $ t e n
tommet	" " t U $ m e t
sääs	" s E: s
svubej	" " s v }: $ " b e j
bove	b u: $ v e
miinna	m I $ I $ n a
mutom	m u0 $ " t o: m
gev	" " j e: v
låssastäcke	" " l O $ s a s $ % t e $ k e
bebibi	" b E: $ b I $ b I
blåab	" " b l o: $ a b
anga	a N $ g a
lyynn	" l y: $ n
atte	" " a $ t e
uppen	" " u0 $ p e n
battine	b a $ " t i: n
tandå	" " t a n $ d o:
itana	I $ " t A: $ n a
mich	m I $ " s`
lucier	l }: $ " " s i: $ e r
jogubbe	" " j U $ % g u0 $ b e
lächa	l e $ s` a
pickan	" " p I $ k a n
fabron	f a $ b r u: n
tsven	" t s t e: n
dyck	" d Y k
pra	p r a
makax	m a $ " k a k s
änenänä	" E: $ n e $ n e $ " n E:
tattaa	" " t a $ t a $ a
tege	" t e: $ g e
jotta	" j O $ t a
mgmi	e m $ g e: $ " e m $ i:
pal	" p A: l
ysch	" " Y s`
nemie	" n e: $ m I
jättedumma	" " j e $ t e $ % d u0 $ m a
poll	" p O l
hinde	" h I n $ d e
sånkinke	" " s O N $ k I N $ k e
gläglätt	" " g l E: $ % g l e t
mng	m N
trmmhähä	t r m $ h e $ h E
dåk	" d o: k
pippippi	" " p I $ p I $ p I
sult	s u0 l t
rätteliten	" " r e $ t e $ % l i: $ t e n
tjäskop	" s' e $ " s k o: p
innestrumper	" " I $ n e $ % s t r u0 m $ p e r
tava	" " t A: $ v a
moddel	" m O $ d e l
joh	j O
poppo	" " p O $ p O
ullå	" " u0 $ l O
vv	" " v e: $ % v e:
lhjul	e l $ % j }: l
ånä	O n E:
kjomme	" " s' U $ m e
pälana	" " p e l A: $ n a
älja	" e l $ j a
kåckena	" k O $ k e $ n a
ytta	" " Y $ t a
yi	" j I
mmn	e m $ e m $ " e n
ox	" O k s
bröbit	" " b r 2: $ % b i: t
sychka	s Y $ " k $ k a
slämma	" " s l e $ m a
joojeoj	" j u: $ x\ e $ " O j
pringer	p r I N $ e r
mitta	m I $ t a
enda	" " e n $ d a
vänna	" " v e $ n a
tosso	" " t O $ s U
kåffe	" k O $ f e
hållang	h O $ " l a N
gach	" g a x\
thäde	" " t E: $ d e
händi	" " h e n $ d I
brumbrö	" " b r u0 m $ % b r 2:
mlopp	" " e m $ % l O p
thaoa	" t a*U $ a
imle	I m $ l e
uggl	" " u0 $ g l
pojkebäbis	" " p O j $ k e $ b E: $ b I s
jivagn	" j I $ % v a N n
avevat	a $ " v e $ v a t
thåka	" " t o: $ k a
groan	" " g r u: $ a n
hmä	" h u0 m E
söd	" " s 2: d
lagja	" " l A: g $ j a
godda	" " g u: d $ d a
määd	" m E: d
emme	" " e $ m e
opti	O p $ " t i:
skortar	" " s k O $ t` a r
talgu	" " t a l j $ % }:
bathummet	b a t $ " h u0 $ m e t
tläte	" " t e: $ % l E: $ t e
jock	" j O k
edaa	e $ " " d A:
thättelånga	t e: $ h e $ t e $ % l O N $ a
mariekex	m a $ r i: $ e $ % k e k s
såhå	s o: $ " h o:
fdö	e f $ d 2:
nämale	n e $ " m A: $ l e
kjill	" " s' I l
neth	" n e t
teiffa	" t e j $ f a
häne	h e $ " n e
niang	n I $ " a N
thlisax	t $ l I $ % s a k s
mnn	" e m $ e n $ " e n
mussi	m u0 $ s I
anras	" " a n $ r a s
iji	I $ d j I
sepa	" " s e: $ p e: $ " A:
flygp	" " f l y: g $ % p e:
nappsapsa	" n a p s $ a p $ s a
gåe	" " g o: $ e
ent	e n t
cyt	" s y: t
gräjä	" " g r e $ j E
bölis	b 9 $ " l i: s
kackagoja	k a $ k a $ " g o: $ j a
marke	" m A: r $ k e
blåck	" " b l O k
haoar	h o: $ A: $ " u: $ a r
grävver	" " g r E: v $ v e r
domben	" " d U m $ % b e: n
ikaj	I $ " " k a j
husdäta	" " h }: s $ d E: $ t a
knäät	" " k n E: $ % E: t
ider	" " i: $ d e r
ådris	" " o: $ % d r i: s
fikapii	" " f i: $ k a $ % p I
thinden	" " t I n $ d e n
ljäsa	j E: $ s a
äblank	" E: $ b l a N k
blännosen	" " b l e $ n U $ s e n
ninta	n I n $ t a
själd	" x\ e l d
lekplatn	" " l e: k $ % p l a t $ n
jigga	" " j I $ g a
bebitis	" b E: $ b I $ t I s
sådan	" " s o: $ d a n
kjini	" s' i: $ n I
bint	" b i: n t
datak	" " d A: $ t a $ % k o:
jyggä	" j Y g $ E
masineng	" " m A: $ s I $ n e N
fjäta	" f j E: $ t a
ödl	" " 2: $ d e l
tjofkalag	" s' O f $ k a $ % l A: g
chåjchgä	" s' O j $ t s' g E:
mäte	" " m E: $ t e
ohohoj	" " u: $ h U $ " h O j
ninnei	" " n I $ n e j
lassbilen	" " l a s $ % b i: $ l e n
tamra	" t a m $ r a
ouu	" O $ U
togge	" t O $ g e
förot	f 9 $ " r o:
motkchyklar	" " m u: t $ k $ s` Y $ k l a r
vlisk	" v l I s k
dagnen	" d a N $ n e n
dathan	d a $ t a n
kao	" k A: $ U
limbock	" l I m $ b O k
dagu	" " d A: $ g u0
jättetjocka	" " j e $ t e $ % s' O $ k a
nättan	" " n e $ t a n
sjej	s` e j
öje	9 $ j e
mämma	" m e $ m a
kange	" k a N $ e
djöpas	" j 2: $ p a s
ninneä	" " n I $ n e E
slättar	" " s l e $ t a r
utek	u0 $ " t e: k
sjunge	" " x\ u0 N $ e
vuppa	v u0 $ p a
dait	d a j t
saa	" s A:
tjaffe	" s' a $ f e
hudlen	" " h }: d $ l e n
möga	" m 2: $ g a
bäebe	" " b $ b e
gläbi	" " g l E: $ % b i:
ginte	g I n $ t e
nehänä	n e $ " h E: n E:
stallflicka	" " s t a l $ % f l I $ k a
boej	b U $ " e j
tjgötha	" s' j 2: $ t a
daö	" " d A: $ % 2:
chaåan	x\ a $ " " o: $ a n
omo	" " u: $ m U
slunge	" " s l u0 N $ e
kronobil	" " k r u: $ n U $ % b i: l
tsittar	t $ s I $ t a r
poå	p U $ % o:
åtvaa	o: t $ v A:
bilet	" " b i: $ l e t
thrää	" t r E:
brööd	" b r 9 2: d
sugu	" " s }: $ g u0
pållee	" " p O $ l i:
datax	d a $ " t a k s
sroj	s r O j
intja	" " I n $ % s' a
morankar	" " m u: $ % r a N $ k a r
eboden	e $ b u: $ d e n
skullde	" s k u0 l $ d e
läjl	" l E: l
fischo	" f I $ s` U
amaam	a $ m a m
giggaa	" " j I $ g a
gösseln	" " j 9 $ s e l n
guldchlickan	" " g u0 l d $ % s' l I $ k a n
vinne	" " v I $ n e
goli	" " g u: $ l I
gagaschet	g a $ " g a $ s` e t
sukhus	" " s }: k $ % h }: s
muljå	m u0 l $ " j o:
emecin	e $ " " m e: $ k I n
dähä	" " d E: E
såssa	" s O $ s a
ammee	a $ " " m e:
barbibäbis	b a r $ b I $ " " b E: $ b I s
tjepax	t s' e t $ " p a k s
köng	" k 9 N
däjen	" d e $ j e n
vattä	" " v a $ t E
tompetåla	" " t U m $ % p e: $ t o: $ l a
hejej	h e j $ " " e j
geggaa	" " g e $ g a $ a
hännena	" h e $ n e $ n a
ställex	" " s t e $ l e k s
käver	" " s' E: $ v e r
älla	e $ l a
pubba	" p u0 $ b a
häspengarna	" " h e s $ % p e N $ a $ n` a
låss	" " l O s
fafp	" f A: $ e f $ " p e:
jaä	" j a E
gismå	" " j i: $ % s m o:
blinä	b l I $ " n E:
höre	" " h 2: $ r e
mammona	" " m a $ m U $ n a
huvekudden	" " h }: $ v e $ % k u0 $ d e n
mästa	" " m e $ s t a
liite	" l i: t
skrumesn	" s k r u0 $ m e s $ n
baas	" b A: s
jitte	" j I $ t e
dae	" d e
gågätha	" " g o: $ % j E: $ t a
beemve	" " b e m $ v e
glikla	" " g l I $ k l a
kioven	s' I $ " o: $ v e n
öppenak	9 $ p e n $ a k
villel	v I $ " l e: l
klala	k l a $ " l A:
äklar	" E: $ k l a r
fåres	" f o: $ r e s
pöpe	" p 2: $ p e
tansade	" t a n $ s a $ d e
krycker	" " k r Y $ k e r
doss	d O s
äå	o:
hättax	" " h e $ t a k s
happa	" h e $ p a
åmdåss	O m $ d O s
bik	" b i: k
onnen	" O $ n e n
måfo	" " m o: $ f U
täf	" " t e f
aninen	a $ n I $ n e n
böstmölk	" " b 9 s t $ m 9 l k
nehäne	n e $ " h e $ n e
nähähähä	n e $ h e $ h e $ h E
tompä	" " t U m $ % p E:
villet	" " v I $ l e t
tjilla	" s' I $ l a
jini	" j i: $ n I
spökona	" " s p 2: k $ U $ n a
heeja	" " h e: $ j a
jumpadoje	" " j u0 m $ p a $ % d O $ j e
hånåd	h o: $ " n o: d
ölåt	" " 2: $ % l o: t
dummä	" d a $ m E
chissa	" s' I $ s a
gligga	g l I $ g a
majmal	" " m a j $ % m A: l
låssatomte	" " l O $ s a $ t O m $ t e
silla	" " s I $ l a
fys	" f y: s
tön	" " t 9 n
meej	m e $ " e j
ämmö	e $ m 2:
flugs	" " f l }: g s
sisken	" " s I $ s k e n
jogobba	" " j O $ O $ b a
såånt	" s o: n t
gucht	" " g u0 $ s` t`
täl	" t E: l
jäg	" " j E: g
sassat	" s a $ s a t
kafa	" " k A: $ f a
filmret	" " f I l m $ r e t
nänää	n e $ " n E:
cirku	" " s I r $ k u0
tjåda	" s' o: $ d a
kintakel	s' I n $ " t a $ k e l
fomme	f U $ m e
hämt	" " h e m t
umum	" " }: $ m u0 m
hoall	" " h u: $ a l
dnen	" d i: $ n e n
åpp	O p
skvintade	" " s k v I n $ t a $ d e
sööt	" s 2: t
sändät	" " s e n d $ % E: t
blöje	" " b l 9 $ j e
fabe	" " f A: $ b e
jättefort	" " j e $ t e $ f O r
nunge	" n u0 N $ e
glip	g l I p
leksakorna	" " l e: k $ s A: $ k U $ n` a
killsake	" " k I l $ s a $ k e
minä	m I $ " " n E:
uthax	" " }: t $ h a k s
namba	" " n a m $ b a
nåjda	" n O j $ d a
vattenet	" " v a $ t e n $ e t
daddl	" " d a $ d e l
halsft	" " h a l s $ f t
däckeen	" d e $ k e $ e n
göna	" " j 2: $ n a
gyy	" j Y I
hiåll	" j O l
kiksikick	" " s' i: k $ s I $ % k I k
mane	" m A: $ n e
pakoja	p a $ " " k O $ j a
boppe	" b O $ p e
atä	a $ t E
smode	" s m u: $ d e
läll	" l e l
måssegumma	" " m O s $ % g u0 $ m a
srar	e s $ r a r
sittej	s I $ " t e j
dlutiaa	d e: $ l }: $ x\ a
edf	e: $ d e: $ " e f
ljyltomten	" l y: l $ % t O m $ t e n
mårrona	" " m o: r $ r U $ n a
tänketenen	" " t e N $ k e $ " t e: $ n e n
lei	" l e j
illax	I $ " l a k s
kammam	" " k a m $ m A: m
glenma	" " g l e n $ m a
rättefott	" " r e $ t e $ f O t
dodiset	" " d u: $ d I $ s e t
shuset	" " e s $ % h }: $ s e t
oton	" " u: $ % t u: n
thatham	" t E: t $ h a m
gääv	" j E: v
hunda	" " h u0 n $ d a
bokax	" " b u: k $ % a k s
sompa	" " s O m $ p a
säkhesbä	" s e $ k e s $ b E:
kråokar	" " k r o: $ % u: $ k a r
yklax	" Y $ k l a k s
mäm	" m e m
viån	" " v i: $ % o: n
trodd	" t r U d
baam	" b a m
pluttu	" " p l u0 $ t }:
ganfram	" " g A: n $ f r a m
stunn	" " s t u0 n
ades	a $ d e s
puskelet	p u0 $ " " s k e: $ l e t
sallade	" " s a $ l a $ d e
glack	" " g l a k
srät	s r E: t
viar	v i: $ a r
rusjkana	r u0 $ " s` k a $ n a
kunge	" " k u0 N $ e
aoja	a $ " " O $ j a
tåckar	" " t O $ k a r
aken	a $ k e n
spinkax	" " s p I N $ k a k s
ittax	I $ " t a k s
slohäst	" " s l u: $ % h e s t
thill	" " t I l
inden	" " I n $ d e n
granbuj	" " g r A: n $ b u0 j
nännä	" " n e $ n E:
ohoho	" " u: $ % h u: $ h U
strutt	" " s t r u0 t
pusken	" p u0 $ s k e n
jonn	" j O n
svampana	" " s v a m p $ % A: $ n a
tsol	" t s u: l
mangkaker	" " m a N $ k a $ k e r
baan	" b A: n
sägg	" s e g
maissch	" m E: s`
bläddax	" " b l e $ d a k s
dähe	" " d E:
sysse	" " s Y $ s e
brumbö	" " b r u0 m $ % b 9
tickax	" " t I $ k a k s
dästedäs	" " d E: $ s t e $ " d E: s
egentlin	e $ " j e n t $ l I n
daäa	d a $ E: $ a
lejlan	" l e j $ l a n
kossona	" " k U $ s U $ n a
maskinorna	m a $ x\ i: $ n U $ n` a
tånna	" " t O $ n a
tjyra	" " s' y: $ r a
fomp	f O m p
koajejaja	k U $ " a $ j e $ j a $ j A:
joghurt	" j o: $ g u0 t`
sotåt	" " s u: t $ o: t
tjoffa	" s' O $ f a
döövä	" d 2: v E
adajt	a $ " d a j t
sunge	" s a n s'
käckä	" s' e k E
djure	" j }: $ r e
naes	" n e
öcha	9 $ s` a
thobba	" t O $ b a
dje	" j e
bjällä	" " b j e $ l E
gorka	" g O r $ k a
fönstet	" " f 9 n $ s t e t
bave	" b e j v
thuvana	t u0 $ " v a $ n a
föa	" " f 2: $ a
stötsar	" " s t 9 t $ s a r
mmää	m I $ l I $ " m E:
nnnnnnn	n $ n $ n
donf	" " d U n $ " e f
yssa	" " Y $ s a
eppsam	e p $ s a m
esses	" e s
taktopullingena	t a k $ " t o: $ p u0 $ l I N $ e $ n a
konte	k O n $ t e
sritta	s r I $ t a
srita	s r i: $ t a
daafs	" d A: v s
adåj	a $ " " d o: $ % j i:
uggeldoktor	" " u0 $ g e l $ % d O k $ t O r
testis	" " t e $ s t I s
kåkae	" " k o: $ k a $ e
deintax	d e $ I n $ " t a k s
glangk	" " g l a N $ k
räsa	" r E: $ s a
slinge	" " s l I N $ e
inste	I n $ s t e
nala	" n a $ l a
åschtå	O s` $ % t` o:
jinkar	" j I N $ k a r
tanne	" " t a $ n e
liljabatten	" " l I l $ j a $ % b a $ t e n
utt	u0 t
ächä	e s` E
svåst	" " s v O s t
gåttare	" g O $ t a $ r e
gisar	" g I $ s a r
sjukdäkt	" " x\ }: k $ d e k t
aämämem	a e $ m e $ m e m
uppfa	" " u0 p $ f a
kajeaia	k a j $ " a $ j a
ombi	" " O m $ b I
ikslaset	I k $ " " s l A: $ s e t
chich	" s' I k
tjö	" s' 2:
hyjer	h Y $ j e r
tjuff	s' u0 f
nannaa	" " n a $ n a $ a
tjönnö	" s' 2: $ % n 2:
nme	e n $ m e
ååå	o: o:
bombom	" " b U m $ % b U m
nääaha	" n E: A: $ h a
nöe	" " n 2: $ e
nau	" n a*U
ktje	k t $ j e
byste	" b y: $ s t e
ossa	O $ s a
ladis	" l e j $ d I s
ndldm	n d` m
tommä	" " t U m $ m E
dädidi	" " d E: $ d a j $ d I
lommena	" " l U $ m e $ n a
suddegummit	" s u0 $ d e $ g u0 $ m I t
tatsa	t a t $ s a
näggen	" n e $ g e n
krufa	" " k r }: $ f a
räde	" " r E: $ d e
håo	h o: $ " u:
duverna	" " d }: $ v e $ n` a
mammamma	m a $ " m a $ m a
såppbil	" " s o: p $ % p $ % b i: l
pumpe	" p u0 m $ p e
vakthus	" " v a k t $ % h }: s
ammo	a $ m u:
kuvax	k }: $ " v a k s
äthå	" E: t $ h o:
mäe	" m E: $ e
spa	e s $ p e: $ " A:
nuuv	" n }: $ v
nämbare	" " n e m $ % b A: $ r e
prrr	p r r
slicke	" s l I $ k e
glamla	" " g l a m $ l a
brevid	" b r e: $ v i: d
tåds	" t o: d s
sukshuset	" " s }: k s $ % h }: $ s e t
jängjö	" " j e n $ j 2:
fengm	f e N $ m
nähän	n e $ " h E: n
säjons	" s e $ j O n s
juken	" j u: k n
täd	" t E: d
kläter	" " k l E: $ t e r
tnycka	" " t e: $ % n Y $ k a
dähöhö	" " d E: 9 $ " h 2:
hääj	" " h E: j
cementlastbil	s e $ " " m e n t $ % l a s t $ % b i: l
ehj	e $ " j
chocke	" " x\ O $ k e
blalla	" b l a $ l a
näg	" n E: g
roler	" r o: $ l e r
åschå	O s` $ % o:
fäl	" f E: l
tåp	" t o: p
tänna	" " t e $ n a
chamma	" x\ a $ m a
lysare	" " l y: $ s a $ r e
flu	f l
beivö	b e $ " i: $ v 2:
uts	" u0 t s
sing	" s I N
äsi	E: $ s I
inns	" I n s
chåa	" " s e: $ % h o: $ a
båecka	" " b O e $ k a
busia	" " b }: $ s I $ a
chöta	" x\ 2: $ t a
tampesthaktor	t a m $ " p e $ s t a k $ t U r
staggstången	s t a g $ % s t O N $ e n
baat	" b a t
saatt	" s A: $ t
sacken	" " s a $ k e n
sle	" " s l e
ehehe	e $ " $ e
näiii	" n e j i:
motsi	" " m u: t $ % s i:
chiko	x\ I $ k U
feden	" f e: $ d e n
väsk	" " v e s k
poss	p O s
tandläkan	" " t a n d $ l E: $ k a n
russinburk	" " r u0 $ s I n $ % b u0 r k
dögö	" d 2: g 2:
igetått	I $ " " j e $ t O t
bejas	" b e $ j a s
åtax	" " o: $ t a k s
näät	" n E: t
idjetått	" " i: d $ j e $ t O t
apalt	a $ " p A: l t
mänä	" " m e $ n I E
hajä	" h a $ j E
släpnagne	" " s l E: p $ % n A: $ g n e
tojpe	" t O j $ p e
såen	" " s o: $ e n
kloff	" k l O f
ävelå	" E: $ v e $ l o:
strumpar	" " s t r u0 m $ p a r
tachit	t a $ " x\ I t
sövisen	" " s 2: $ v I $ s e n
suvva	" s a $ v a
tanbostana	t a n $ b u: $ s t A: $ n a
chösti	x\ 9 $ s t I
jagn	" j a N n
fantes	" " f a n $ t e s
jordgobb	" " j u: d` $ % g O b
gacke	" " g a $ k e
aaaaa	" o: o: $ a
marmeladslocket	m a r $ m e $ % l A: d s $ % l O $ k e t
tyklöver	" " t y: $ k l 2: $ v e r
äfons	E: f o: n s
ojås	" " u: $ x\ o: s
kvälle	" k v e $ l e
tattod	t a t $ " " t u: d
nöä	" n E
fomsa	f O m $ s a
gävasin	" " j E: $ v a $ " s i: n
tsom	" t s O m
hinge	" h I N $ e
sassen	" s a $ s e n
mammalen	m a $ " m A: $ l e n
möcken	" m 9 $ k e n
höhm	" h 9 m
säppi	" s e $ p I
däänka	" d e e N $ k a
pippifilm	" " p I $ p I $ % f I l m
thessna	t e $ s n a
djääs	" " j E: s
morör	" " m u: $ % r 2: r
deta	d e $ t a
snickebyxer	s n I $ k e $ " " b Y k $ s e r
söthe	" " s 2: $ t e
drax	" d r a k s
fåoka	" " f o: $ % u: $ k a
äaa	A:
bomppbuss	" " b U m $ u0 p $ % b u0 s
jejon	j e $ j O n
lingranen	" " l i: N $ % g r A: $ n e n
fickä	" " f I k $ % E:
bandspelan	" " b a n d $ % s p e: $ l a n
kyk	s Y $ " k o:
dau	" d a*U
tsanna	t s a $ n a
flyplane	" " f l y: $ % p l A: $ n e
skuppt	" s k u0 p t
niningen	" " n I $ n I N $ e n
måda	" " m o: $ d a
pappaapa	" " p a $ p a $ % A: $ p a
pate	" p A: $ t e
butat	b }: $ " t A: t
pannkaker	" " p a n $ % k A: $ k e r
sjomme	x\ U $ m e
muela	m u0 $ " e: $ l a
håda	" h o: $ d a
thättetholi	t e: $ h e $ t e $ t O $ l I
lel	" l e: l
ajs	" a j s
håchaa	" h O s' A:
milamia	m I $ " " l A: $ m I $ a
chicko	" " s' I $ k U
maga	" " m A: $ g a
tjitj	" s' I t s'
säå	" " s E: $ % o:
naje	" " n a $ j e
vinkax	" " v i: n $ % k a k s
gävl	" j e v l
aåch	a $ " O s`
meve	" m e: $ v e
tissekatt	" " t I $ s e $ " k a t
vagne	" v a N $ n e
chät	" s' E: t
dissiklubben	d I $ s I $ " k l u0 $ b e n
tenana	" t e $ n a $ n a
feiste	" " f e j $ s t e
tåver	" " t o: $ v e r
kibba	" " s' I $ b a
allax	a $ " l a k s
gonga	" " g O N $ a
gila	" g i: $ l a
jätta	" " j e $ t a
tats	t a t s
gub	" " g u0 b
gost	" " g O s t
ukecka	}: $ " k e $ k a
seut	s e $ " }: t
badin	b a $ " d i: n
jäte	" " j E: $ t e
billax	" " b i: l $ % l a k s
kockat	" " k O $ k a t
filmöken	" " f I l m $ % 2: $ k e n
mbrmmum	e m $ b e: $ " " e r m $ m u0 m
traktopullingana	t r a k $ t U $ p u0 $ l I N $ a $ n a
väganä	" " v E: g $ a n E:
däänd	" d e e n d
gummaa	g u0 $ " m A:
mhu	m e $ g a $ " h }:
sjukba	" " x\ }: k $ b a
kommera	k O $ " m e: $ r a
petteson	p e $ " t e $ s O n
chlilla	k l I $ l a
ätnö	" E: t $ n 2:
stössel	" " s t 9 $ s e l
mofar	m U $ " f A: r
sung	" " s u0 N
chat	s` a t
psappa	" " s a $ p a
krupa	" " k r }: $ p a
doppax	" " d O $ p a k s
stö	" s t 2:
kote	" k O $ t e
namm	" " n a m n
bääbee	" " b E: $ b I
kle	k l e
hastes	" h a $ s t e s
echtn	" e x\ t n
blåsit	" " b l o: $ s I t
gäpata	" g e $ p A: $ t a
ficken	" " f I $ k e n
chao	" s' a*U
konstglösslare	" " k O n s t $ % g l 9 $ s l a $ r e
köth	" k 2: t
ispa	I $ s p a
öndä	9 n $ d E:
juffä	" j a $ f E:
rejer	" " r e $ j e r
snk	" s n k
ugaför	}: $ " g a f 2: r
nyckelen	" " n Y $ k e l $ e n
förskräckleit	f 9 $ " s` k r e $ k l e j t
madao	m a $ d a $ " u:
mokchliklar	m O k $ " s` $ l I $ k l a r
lillbaj	" " l I l $ % b a j
göö	" j 2:
sydden	" " s Y $ d e n
mammaei	" " m a $ m a $ e $ " i:
spike	" s p i: $ k e
puttat	" " p u0 $ t a t
gåår	" " g o: $ % o: r
facki	" " f a k $ I
heth	h e t
tatten	" " t a $ t e n
däskit	" " d E: $ % x\ i: t
hästol	" " h e $ s t u: l
tyk	" t y: k
dammsugkontakt	" " d a m $ s }: g $ k O n $ % t a k t
chlänni	k l e $ n I
gjömma	" " g l 9 $ m a
sanslåda	" " s a n s $ % l o: $ d a
kän	" k e n
pippianduk	" " p I $ p I $ a n $ % d }: k
thisk	" " t I s k
gigga	" " j I $ g a
fosta	" " f U $ s t a
gläklippare	" " g l E: $ % k l I $ p a $ r e
voppää	" v O $ p E:
värs	" v E: s`
dådå	" " d o: $ d O
kasche	k a $ " " s` e
chatch	x\ O t s'
mövlena	" m 9 v $ l e $ n a
randia	" " r a n $ d I $ a
dägå	" " d e g o:
moröttö	" " m u: $ % r 9 $ t 9
emle	e m $ l e
lullaa	" " l u0 $ l a $ a
gafet	" " g A: $ f e t
muss	" " m u0 s
tanstorena	" " t A: n s $ " t u: $ r e $ n a
blonge	" b l O N $ e
huckeluskan	" " h u0 $ k e $ " l u0 $ s k a n
gulas	" " g }: $ l a s
tåssasvatten	" " t O $ s a s $ % v a $ t e n
höös	" h 2: s
greje	" g r e $ j e
chfå	" s' f o:
klabit	k l a $ " b i: t
ndäs	e n $ " d E: s
prra	" p r a $ r a
glöck	" " g l 9 k
nenge	n e N $ e
såon	s o: $ " O N
kodde	k U $ d e
ragn	" " r a N n
vällit	" " v e $ l I t
häge	" " h E: $ g e
etax	e $ " t a k s
gvok	g e $ " v o: k
tofå	" " t u: $ % f o:
vulla	v u0 $ l a
andeson	" " a n $ d e $ % s o: n
neingä	" n e j n $ j E:
lejekung	" " l e $ j e $ % k u0 N
thoppa	" t O $ p a
pommana	" p O $ m a $ n a
däee	" d e i:
åttis	" " O $ t I s
smulax	" " s m }: $ l a k s
lnana	e l $ e n $ " " A: $ n a
tjånne	" s' O $ n e
vappen	" v a $ p e n
thätte	t e $ t e
jidaa	j I $ " d A:
peling	p e $ l I N
jiv	" j i: v
håål	" h o: l
attax	a $ " t a k s
näng	" n e N
lisona	" " l i: $ s U $ n a
thäs	" " t E: s
atn	A: $ t e: $ " e n
gosax	" " g u: $ s a k s
tankbosche	" " t a N k $ % b O $ s`
gnattar	" g n a $ t a r
klagge	" k l a $ g e
äo	U
thicka	" " t I $ k a
jeje	j e $ j e
jåra	" j o: $ r a
granngu	" " g r a N $ g u0
fänilar	" " f E: N $ % i: $ l a r
glasögona	" " g l A: s $ % 2: $ g U $ n a
thillax	t I $ " l a k s
ighåg	" " I $ % h o: g
mikofonen	" m I $ k U $ " f o: $ n e n
plumplanet	" " p l u0 m $ % p l A: $ n e t
tuda	" " t }: $ d a
bichen	" b I $ s` e n
goåcka	g U $ " " O $ k a
nickes	" " n I $ k e s
djicke	d j I $ k e
tartax	t a $ t` a k s
datsempel	" d a t $ s e m $ p e l
morött	" " m u: $ % r 9 t
nälettaa	" " n E: $ l e $ " t A:
vp	" " v e: $ % p e:
chöda	" x\ 2: $ d a
åjaj	" " o: $ j a j
lyltomta	" l y: l $ % t O m $ t a
jättedor	" " j e $ t e $ % d O r
lekslake	" " l e: k $ s l e j k
thock	" t O k
hatha	" h A: $ t a
kåva	" " k o: $ v a
ptatis	" " p e: $ % t A: $ t I s
jjj	" " j i: $ j
soptunne	" " s u: p $ % t u0 $ n e
embå	a N $ b o:
tjåjen	" s' o: $ j e n
äha	E: a
trägårn	" t r E: $ g o: n`
brmbö	b e: $ e r $ " e m $ b 2:
tommisen	" t O $ m I $ s e n
trycke	" t r Y $ k e
troser	" " t r u: $ s e r
lördagodis	" l 2: $ d` A: g $ % g u: $ d I s
dehä	d e $ h E
tjippa	" s' I $ p a
katse	" " k a t $ s e
chåj	" s' O j
kokodilen	" k U $ k U $ % d i: $ l e n
mångaa	" " m O N $ % A:
srejer	s r e $ j e r
taamma	t a $ " " a $ m a
ulfest	" " }: l $ % f e s t
anatåg	a $ n a $ % t o: g
tubbith	" " t u0 $ b I t
bilkassong	" " b i: l $ k a $ " s O N
honungkaka	" " h o: $ n u0 N $ % k A: $ k a
överraskax	" " 2: $ v e $ % r a s $ k a k s
peksinge	" p e: k $ s I N $ e
lämn	" " l e m n
äjda	e j $ d a
tjåä	" s' O E
thilm	" " t I l m
tjöfhä	" s' 2: v $ h E
fne	" " f n
finga	" f I N $ g a
alrer	" " A: l $ r e r
byråna	" " b y: $ r o: $ n a
nähähää	n e $ h e $ % h E:
muus	" m }: s
cåmillor	k O m I $ l U r
delt	" d e: l t
päsch	" p E: s`
nejnä	" " n e j $ n E:
betäl	b e $ " " t E: l
thättelitet	t e: $ h e $ t e $ % l i: $ t e t
tåddit	" " t O $ d I t
vonsalva	" f O n $ % s a l $ v a
ahåhåhå	a $ " h o: $ " h o: $ " h o:
pufsax	" " p u0 f $ s a k s
rära	" r E: $ r a
gåden	" " g o: $ d e n
voll	v O l
kake	" " k A: $ k e
gjilla	" j I $ l a
bämbil	" b e m $ % b i: l
conelia	k O $ " n e: $ l I $ a
moumsen	" m a $ u0 m $ s e n
dedda	d e $ d a
kåtlch	" " k o: t $ l k
misstäck	" " m I $ s t e k
fypane	f Y $ p a $ n e
ifrån	I $ " " f r o: n
römmen	" r 9 $ m e n
hääpp	" h e e p
mytte	" " m Y $ t e
kåninena	" " k O $ n I $ n e $ n a
pojkenn	" " p O j $ k e n
biip	" " b i: $ i: $ " p e:
soop	" s u: p
könne	" k 9 $ n e
ipan	i: $ p a n
essge	" " e s $ g e
balskor	" " b A: l $ s k U r
gubbi	" " g u0 $ b I
såppa	" " s o: p $ p a
thusen	t u0 $ s e n
tlött	t l 9 t
såst	" s O s t
kampin	k a m $ " p i: n
pge	p e: $ g e
kott	" k O t
rättesikti	" " r e $ t e $ % s I g $ t I
daffle	" d a $ f l e
mmhm	e m $ e m $ " " h o: $ % e m
slickona	" " s l I $ k U $ n a
bahaja	b a $ h a $ j a
vvv	v e: $ v e: $ " v e:
såljs	" s O l j s
njoa	" n j u: $ a
vska	" " v e: $ e s $ k O $ " A:
åe	" " o: $ e
vull	v u0 l
ybilät	Y $ " b l E: t
pritad	" p r i: $ t a d
kaks	" k A: k s
tseeit	" t s i: $ I t
ärtat	e $ t` a t
kjunne	" s' u0 $ n e
thätt	t e t
trolves	" t r O l $ v e s
bidd	" b I d
rutschka	" " r u0 t` s` $ % k A:
pmpok	p e: $ e m $ " p o: k
rapaba	" " r A: $ p a $ b a
tholit	t U $ " l i: t
mäp	" m E: p
mkch	e m $ k o: $ " s`
sän	" s E: n
ksen	k $ s e n
kjäa	s' e n I N
usu	}: $ e s $ " }:
thek	" " t e: $ % k o:
chippa	" s' I $ p a
senerna	" s e: $ n e $ n` a
koa	" " k u: $ a
kåj	k o: r j
naina	" n a j $ n a
nueh	" n }: $ e
ninla	n I n $ l a
åddä	O $ d E
grodena	" " g r u: $ d e $ n a
fraa	" f r a n s k a
issee	I $ " s i:
omv	u: $ e m $ " v e:
dåppa	" d o: $ p a
perääp	" p e $ r e $ " " E: p
pämma	" p e $ m a
elefot	e $ l e $ " " f o: t
gääng	" g e $ e N
tjabend	" s' a p e n d
hantag	" " h A: n $ % t A: g
brn	b e: $ e r $ " e n
julklappa	" " j }: l $ % k l a $ p a
läggda	" " l e g $ % d a
känni	" " s' e $ n I
kycker	" " k Y $ k e r
tlett	t I $ " l e t
batf	b a $ " " t e: $ % e f
mammerna	" " m a $ m e $ n` a
kjung	" " s' U N
hudet	" h }: $ d e t
lygplan	" " l Y N $ % p l A: n
sääm	" s E: m
biptaapp	" b I p $ t a $ a p
huet	h u0 $ " e: t
jättetake	" " j e $ t e $ % t A: $ k e
innis	" " I $ n I s
pengana	" " p e N $ a $ n a
tannkräm	t a n $ % k r E: m
babidocka	b a $ b I $ % d O $ k a
lavit	l a $ " v i: t
pöppa	" p 9 $ p a
ässrä	e s $ r E
fokla	f U $ k l a
psapp	" " s a p
snuu	" " s n }:
bullare	" " b u0 $ l a $ r e
flickerna	" " f l I $ k e $ n` a
flonni	" f l O $ n I
näaaaaa	n e $ " o: o: $ a
svat	" s v A: t
aat	" A: t
byckö	" b Y $ % k 2:
tjäke	" " s' E: $ k e
sien	" s i: n
möjlit	" " m 9 j $ l I t
masso	" " m a $ s U
hushållsost	" " h }: s $ h O l s $ % U s t
taset	" " t A: $ s e t
tallerik	" " t a l $ " " e: $ r I k
bedälä	b e $ " d e $ l E
hnch	h n` s`
pillö	" " p I l $ % 2:
buppä	" b u0 $ p E
kanok	k a $ " n u: k
åffåff	O $ f O f
blädd	" " b l e d
nene	" " n e $ n e
denj	d e $ n j
ricker	" " r I $ k e r
bangax	" " b a N $ a k s
thikti	" " t I g $ t I
etn	" e: $ t e: $ " e n
nopp	" " n O p
madinsa	m a $ " d I n $ s a
dähähä	" " d E: e $ h E
mutsi	" " m }: t $ s I
brummak	" " b r u0 $ m a k
bannspelare	" " b a n $ % s p e: $ l a $ r e
ljite	l I $ t e
mjoliu	" " m j u: $ l I $ U
jättaså	" " j e $ t a $ s O
munne	" m u0 $ n e
rän	" r E: n
möklad	" " m 2: $ % k l A: d
denu	d e $ n }:
sageth	" s a $ g e t
ige	I $ g e
säns	" s E: n s
tatter	" " t a $ t e r
ebä	" e p E
blukax	" b l u: k a k s
hält	" " h e l t
senp	" " s e: n $ % p e:
äjä	e $ j E
thräril	" t r E: $ r I l
tillekp	t I l $ " " e: $ k o: $ " p e:
nyfike	" " n y: $ % f i: $ k e
tjonsia	" s' u: n $ s I $ a
vaaaa	" v a A:
slöck	" s l 9 k
tsäng	" t s e N
enambo	" " e: n $ a m $ b u:
nost	" n O s t
thädd	" " t E: d
ditti	" d I $ t I
tover	" " t u: $ v e r
xxxillana	" k s k $ s I $ " " l A: $ n a
vaang	v a $ " a N
siraffen	" " s i: $ r a $ f e n
cheppa	" s' e $ p a
aaba	" o: $ b a
tjöket	" s' 2: $ k e t
popiäbjäbabje	" " p O p $ I $ e $ " b j e b E: $ b j e
beka	b e $ " k a
gräsklippa	" " g r E: s $ % k l I $ p a
ksönne	k $ s 9 $ n e
sönst	" s 9 n $ d s t
tampe	" t a m $ p e
fokela	f O $ k e $ l a
chöke	" x\ 2: $ k e
igepå	I $ " " j e $ p o:
hetax	h e $ " t a k s
soma	" s u: $ m a
hman	$ m a n
kjockat	" s' O $ k a t
ääuäej	E: e j
ahaa	a $ " h A:
chenj	x\ e $ n j
chit	" s' a j t
tsotar	" t s u: $ t a r
apena	a $ p e $ n a
bade	b a $ d e
klädä	" " k l E: d $ % E:
vädte	" " v E: d $ t e
påke	" p o: $ k e
öhöö	" " 2: $ h 2:
miskö	m I $ " s k 2:
thinga	" " t I N $ a
pöbö	" " p 2: $ b 2:
byxo	" " b Y k $ s U
vthm	v e: $ t m
gapp	" g a p
asså	a $ " s o:
tätopare	" " t E: t $ U $ p a $ r e
siktit	" " s I k $ t I t
fåår	" " f o: $ % o: r
sifst	" s i: v s t
jia	" j i: $ a
bolax	" " b u: $ l a k s
häle	h E: $ l e
sångax	" " s O N $ % a k s
kjort	" " s' U t`
spand	" s p a n d
brinde	" " b r I n $ d e
gåä	g U E
gäsopa	" g e $ % s u: $ p a
nään	" n E:
sädda	" s e $ d a
glögge	" g l 9 $ g e
jätteminst	" " j e $ t e $ % m I n s t
älkax	" e l k $ % a k s
armo	" " a r $ % m u:
aoch	a $ " " O k
cyken	" " s Y $ k e n
jättetrångt	" " j e $ t e $ % t r O N t
deken	d e $ k e n
lamta	" " l A: m $ t a
jaaa	" j A: $ a
pippe	" " p I $ p e
lessub	" " l e $ s u0 b
vnga	" " v e: $ e N $ g a
baand	b a $ % a n d
köttbull	" " s' 9 t $ b u0 l
knyppit	" " k n Y $ p I t
jymma	" j Y $ m a
såv	s o: $ " v e:
napen	n a $ p e n
kisser	" " k I $ s e r
kiljacka	" " s' i: l $ % j a $ k a
däät	" d E: t
nige	n I $ g e
hypan	h Y $ p a n
tanbotte	t a n $ b O $ t e
fok	" " f u: k
räcerbåt	r e $ " " s e: r $ % b o: t
brommer	" " b r O $ m e r
mekano	m e $ " k A: $ n U
ätiä	e $ " j E:
bläddar	" " b l e $ d a r
heh	" " h e: $ % h o:
enä	e $ " n E:
bette	" b e t
näil	" n e j l
mangnan	m a N $ " g n a n
tart	t a $ " t`
tsassa	t s a $ s a
mänchona	" m e n $ t s' U $ n a
tänn	" " t e n
sikslubba	" s I k $ s l u0 $ b a
ukax	}: $ " k a k s
dulla	" d u0 $ l a
gikana	j I $ " k A: $ n a
deth	d e t
papi	p a $ p I
ryygg	" r y: g
baoken	b a $ " o: $ k e n
såp	" " s o: p
kaetä	" k E: $ t E
tsex	" " t s e k s
safp	" s A: $ e f $ " p e:
ktu	k o: $ t e: $ " }:
tåche	" " t O s`
titu	" t i: $ t u0
tevä	" " t e: $ v E
åmila	" " o: $ " " m I $ l a
krits	" k r I t s
bortaa	" " b O t` $ a
tjofå	" s' O f o:
palit	p a $ " l i: t
åf	O f
haapp	" h A: $ p e: $ " p e:
tannborste	t a n $ % b O $ s` t` e
fångax	" " f O N $ % a k s
engk	" " e N $ % k
ljäppa	j e $ p a
tobbax	" " t O $ b a k s
skyylt	" x\ y: $ l t
gääsa	" j E: $ s a
supan	" " s }: $ p a n
medecin	" " m e: $ d e $ s I n
bruggerna	" " b r u0 g $ j e $ n` a
brännosen	" " b r e n $ % n u: $ s e n
nennaa	n e $ " n A:
baäsfäre	" b e e $ " s f E: $ r e
motoa	m U $ t U $ a
sråga	s r o: $ g a
lultomten	" " l }: l $ % t O m $ t e n
sönner	" " s 9 $ n e r
bendi	" b e n $ d I
dänä	" d E: n E:
geche	" g e k e
kjeck	" " s' e k
setannax	" " s e t $ a $ % n a k s
titå	t a j $ " t o:
statar	" " s t A: $ t a r
gafflen	" " g a $ f l e n
chytta	" " s e: $ % h Y $ t a
barbis	" b A: r $ b I s
tångene	" " t O N $ e $ n e
nöch	" n s`
tjoppe	" s' O $ p e
äx	e k s
honge	" " h O N $ e
vli	" v l i:
hushus	" " h }: s $ % h }: s
tsängen	" " t e: $ % s e N $ e n
teket	" " t e: $ k e t
duum	d }: $ u0 m
plusåftan	" " p l u0 s $ o: f $ t a n
dafe	d a $ " f e:
srindan	s r I n $ d a n
fånte	" " f o: n $ t e
hejaj	" " h e $ j a j
ellade	" " e $ l a $ d e
murt	" m 2: t`
uf	" " }: $ % e f
lillasy	" " l I $ l a $ % s Y
egj	e $ " j
gätä	" j E: t E
bajspelare	" " b a j s $ % p e: $ l a $ r e
dääd	" d E: d
ögö	" " 2: $ g 2:
batan	b a $ " t A: n
pustani	p }: $ " s t A: $ n I
singret	s I N $ g r e t
legot	" " l e: $ g U t
schinga	" s` I N $ a
rädla	" r E: d $ l a
chloffe	k l O $ f e
jättejam	" " j e $ t e $ % j a m
hämpa	" " h e m $ p a
halsbandena	" " h a l s $ % b a n $ d e $ n a
tesås	" " t e: $ % s o: s
psike	" " s a j k
daå	" " d A: $ % o:
nåstins	" n O $ s t I n s
kollax	" " k o: l $ % l a k s
ääs	E: s
jättelängesen	" " j e $ t e $ % l e N $ e $ % s e n
gäte	" j E: $ t e
någå	" " n o: $ % g o:
dennaa	" " d e $ n a $ a
bakbena	" " b A: k $ % b e: $ n a
sålen	" " s o: $ l e n
thara	" " t A: $ r a
sör	" s 2: r
gånax	g o: $ " n a k s
siä	" s E
thing	" " t I N
cyk	s Y $ " k o:
buppe	" b u0 $ p e
nuvi	" " n }: $ v I
nete	" " n e: $ t e
tjedde	" s' e $ d e
häckena	" " h e $ k e $ n a
tälla	" " t e $ l a
maapp	" m A: $ p
meä	m e $ " E:
kullre	" " k u0 l $ r e
ailt	" " A: $ i: l t
paddå	" " p a $ d o:
jajs	" j a j s
nmbrm	" " e n $ e m $ b e r m
däbi	" " d E: $ b I
bepto	b e p $ t U
rutena	r u0 $ " t e: $ n a
äaja	$ j a
åhi	" " o: $ h I
prrprroö	p r $ p $ r U $ % 2:
atsa	a t $ s a
tessi	" t e $ s I
hönse	" h 9 n $ s e
thato	" " t A: $ t U
kaulolin	" k a*U $ l U $ l I n
kongan	k O N $ " g A: n
pilta	" " p I l $ t a
lömme	" " l 9 $ m e
bläjer	" " b l e $ j e r
chni	s` n` I
skinsk	" x\ i: n s k
srova	s r o: $ v a
basj	b a x\
nagnä	" " n a $ n E:
tavler	" " t A: v $ l e r
lekpla	" " l e: k $ % p l a
äver	" E: $ v e r
mida	" " m i: $ d a
dorva	" d O r $ v a
massin	m a $ " s i: n
ockå	" " O $ % k o:
alldese	" " a l $ d e $ s e
slyk	" s l y: k
chäja	x\ e $ j a
svite	" " s v i: $ t e
pöke	" p 2: $ k e
laset	" " l A: $ s e t
spikana	" " s p i: k $ % A: $ n a
stussax	" " s t u0 $ s a k s
pade	p a $ d e
ööör	2: 9 r
kåi	k O $ i:
hmga	h o: $ e m $ g e: $ " A:
hatax	" " h A: t $ % a k s
madas	" " m A: $ d a s
låx	" l O k s
sänggalt	" " s e N $ % g A: l t
nallebjön	" " n a $ l e $ % b j 2: n
nåe	" " n o: $ e
hålld	" h O l d
juum	" j }: m
negga	n e $ g a
sje	s` e
tark	" t a r k
dåckax	" " d O k s $ % a k s
höenkakle	" " h 2: $ a N $ % k A: $ k l e
dammmsugkontakten	" " d a m $ % m $ s }: g $ k O n $ % t a k $ t e n
stranse	" s t r a n $ s e
bucke	" b a $ k e
årona	" " o: $ r U $ n a
hanlät	" " h A: n $ % l E: t
farbe	" " f a r $ b e
djå	" j o:
småa	" " s m o: $ a
fiin	f I $ " i: n
jiig	" j i: $ I g
dockona	" " d O $ k U $ n a
smörje	" " s m 9 r $ j e
thäkna	" " t E: $ k n a
tackam	t a $ " k A: m
kälf	" " s' e l f
lugsvamp	" l }: g $ % s v a m p
däihii	" d e j $ h I
måssax	" " m o: s $ % s a k s
goapp	g U $ " " a p
jaab	" " j A: $ a b
chta	x\ $ t a
dähär	" " d E: E: r
monto	" m O n $ t U
mite	" " m i: $ t e
tallik	" " t A: l $ % l i: k
pummaa	" " p u0 m $ m A:
dannax	" " d a $ n a k s
jånn	" j O n
biilen	" " b i: $ % i: $ l e n
åkepoj	" " o: $ k e $ p O j
söttena	" " s 2: t $ t e $ n a
fåk	" f o: k
tudden	" t u0 $ d e n
nulla	n u0 $ l a
uää	}: $ " " E:
doke	" d u: $ k e
bjåsj	" b j O s`
öppamera	9 $ p a $ % m e: $ r a
bessa	" " b e $ s a
sångar	" " s O N $ a r
hoånd	" h O O t
teger	" " t e: $ g e r
hånst	" h o: n s t
myckle	" " m Y $ k l e
båppå	" " b O $ " p o:
huga	" " h }: $ g a
bylana	b Y $ " l a $ n a
gtj	g s'
hönon	" " h 2: $ n U n
lte	e l $ t e
frågax	" " f r o: g $ % a k s
dädad	" " d E: $ d a d
borka	" " b O r $ k a
sjäkar	" " x\ E: $ k a r
julgjanen	" " j }: l $ g $ j a $ n e n
nivan	" n i: $ v a n
doton	" " d u: $ t O n
lessenat	" " l e $ s e $ n a t
sälskebälte	" " s E: l $ s k e $ % b e l $ t e
vämle	" " v e m $ l e
sängt	" s e N t
prusiluskan	p r }: $ " " s i: $ l u0 $ s k a n
däsbor	" d E: s $ % b u: r
spananena	" " s p A: $ n a $ n e $ n a
issaa	I $ " " s A:
behös	b e $ " h 2: s
håget	" " h o: $ g e t
tampax	t a m $ " p a k s
chicho	" t s' I t $ s' O
julkla	" " j }: l $ k l a
däppe	" d e $ p e
päng	" p e N
nua	" n }: $ a
sunkar	" " s u0 N $ k a r
svåa	" " s v o: $ a
glaat	" g l A: t
jella	" j e $ l a
slubban	" " s l u0 $ b a n
längtax	" " l e N $ t a k s
momba	m O m $ b a
jcha	" j t s' a
bjöön	" b j 2: n
bloackax	b l U $ a $ " k a k s
tesammans	t e $ " s a $ m a n s
dlhmdä	d e $ s I $ " l i: $ " m E
vaar	" v A: r
hållå	" " h O l $ % o:
nlatten	e n $ " l a $ t e n
danj	d a $ " n j
hippi	" " h I $ p I
hodung	" " h u: $ % d u0 N
mäga	" m E: $ g a
kågga	" " k o: g $ g a
sängana	" " s e N $ % A: $ n a
sorond	" s O $ % r O n d
brinne	" " b r I $ n e
daall	" d A: l
såe	" " s o: $ e
linva	" " l i: n $ v a
punge	" " p u0 N $ e
pakerat	p a $ " k e: $ r a t
pfine	" " p e: $ % f i: $ n e
ndak	e n $ % d a k
nigi	" " n i: $ g I
sååa	s o: $ " o: $ a
bödet	" " b 2: $ d e t
kjatt	" s' a t
spsps	" s p s p s
pakan	" p a $ k a n
hästbäck	" " h e s t $ % b e k
kickä	" " k I $ k E
kikan	" " s' i: $ k a n
mammo	" " m a $ m U
väägä	" v E: g E:
hiii	" h i: i:
låka	" " l o: $ k a
uka	}: $ k a
bluggan	" b l u0 $ g a n
rusti	r u0 $ " s t i:
spega	" " s p e: $ g a
tjidam	" s' i: $ d a m
gum	" " g u0 m
rinnä	r I $ " n E:
smömås	" s m 2: $ % m o: s
geee	d j i:
däkna	" " d E: $ k n a
gääs	" j E: s
kfönku	k o: $ e f $ " " 9 N $ k U
slåst	" s l o: s t
hånna	" " h o: n $ n a
kosk	" k O s k
dascha	" " d a $ s` a
hitha	" " h I $ t a
ringlomma	" " r I N $ l U $ m a
fumma	" f u0 $ m a
denka	" d e N $ k a
gäta	" j E: $ t a
tjåba	" s' o: $ b a
sänner	" " s e $ n e r
groder	" " g r u: $ d e r
mochet	" " m O $ x\ e t
bejet	" " b e $ j e t
öpas	" " 2: $ p a s
gosik	" " g u: $ s I k
escht	e $ " s k t
gåchä	" " g O s` E
bäbise	" b E: $ b I $ s e
tallrikä	" " t a l $ r I k E
argä	a r $ " " g E:
mimelia	m I $ " " m e: $ l I $ a
tjäfå	" " s' E: $ % f o:
räckekoje	" " r e $ k e $ % k O $ j e
schela	" " x\ e: $ l a
mövlaj	" m 9 v $ " l a j
mikadan	m I $ k a $ " d A: n
vatta	" " v a $ t a
myda	m y: $ d a
geter	" j e: $ t e r
vagnem	" " v a N n $ % e: m
pussax	" " p u0 $ s a k s
bebisana	" b E: $ b I $ s a $ n a
paå	p a $ % o:
gössen	" " j 9 $ s e n
hevånad	h e $ v o: $ n a d
nåo	" " n o: $ U
lejonkung	" " l e $ j O n $ % k u0 N
lammat	" " l a $ m a t
hina	" h i: $ n a
domp	d O m p
chunn	" " x\ u0 n
hjämen	" j E: $ m e n
esrak	" e s $ r e j k
sommaen	" " s O $ m a $ e n
lädda	" l e $ d a
föru	f 9 r $ " }:
telar	t e: $ l a r
saloppera	s a $ " l O $ p e $ r a
nannen	" " n a $ n e n
trutton	" t r u0 $ t O n
srike	s r i: $ k e
ach	a $ " k
ödäka	" " 2: d $ E: $ k a
bromm	b r U m
tsänne	" t s e $ n e
blyydd	" " b l y: $ % Y d
rfover	" " e r $ e f $ u: $ v e r
lisbile	" l i: s $ b i: l
fokten	f O k $ t e n
smu	" " s m }:
sågax	" " s o: g $ % a k s
jelefantena	j e $ l e $ % f a n $ t e $ n a
såsnåd	" " s o: $ s n o: d
daad	" d A: d
dammsu	" " d a m $ s }:
dääl	" d e E: l
uhm	" " }: $ m
åten	" " o: $ t e n
munet	m }: $ n e t
roden	" " r o: $ d e n
såba	" " s o: $ b a
thättestora	t e: $ h e $ t e $ % s t u: $ r a
dubbä	d u0 $ " " b E:
lun	" l }: n
tommin	" t O $ m I n
sokladgodis	s U $ " " k l A: d $ % g u: $ d I s
döå	" " d 2: $ % o:
tsåm	" t s O m
sföre	" " e s $ % f 2: $ r e
bva	b e $ v a
pissen	" p I $ s e n
gakana	g a $ " k A: $ n a
hädde	" h e $ d e
apesin	" " A: $ p e $ % s i: n
käte	" k E: t
seta	" " s e: $ t a
dol	" d o: l
såb	s o: $ " b e:
lenka	" " l e N $ k a
tåglä	" " t o: g $ l E
offoff	O f $ " " O f
thryckte	" t r Y k $ t e
mummum	" m u0 $ m u0 m
sapse	" s a p $ s e
bei	b e $ " i:
läggandär	" " l e $ g a n $ " d E: r
däne	" " d E: $ n e
stula	" s t U $ l a
vangnet	v e N $ " g n e: t
åovepå	O U v $ % p o:
tålit	" " t o: $ l I t
tura	" " t }: $ r a
skåta	" " s k o: $ t a
sminksake	" " s m I N k $ % s A: $ k e
spide	" s p a j $ d e
jättetrö	" " j e $ t e $ % t r 2:
dlää	d e $ s I $ " l E:
säda	" s e $ d a
nuf	" n u0 f
tanse	" t a n $ s e
ringväll	" " r I N $ % v e l
lenasaker	" " l e: $ n a $ % s A: $ k e r
tysstyssti	" " t Y $ s t Y $ " s t i:
näaa	" n e A:
hedi	h e $ " d i:
nuse	" " n }: $ s e
skedana	" " x\ e: $ d a $ n a
baten	" b A: $ t e n
plicken	" p l I $ k e n
lopple	" " l O $ p e l
hagabadet	" " h A: $ g a $ % b A: $ d e t
gaff	" g a f
bellasång	b e $ l a $ % s O N
bappa	b a $ p a
katha	" " k A: $ t a
jult	" " j }: l $ % t e:
gåljta	" " g o: l j $ t a
pangax	" " p a N $ a k s
lesseen	" " l e $ s e $ e: n
äggan	e $ g a n
dinosauje	d I $ n U $ " " s a*U $ " s`
mammafågen	" " m a $ m a $ f o: $ g e n
tasing	" " t A: $ s I N
nassa	" " n a $ s a
kåchoa	k O $ x\ U $ a
tsns	" t s n s
nuda	" n }: $ d a
thäril	" " t E: $ r I l
slamas	" " s l A: $ m a s
alchting	a l $ k $ t I N
havvor	" " h A: v $ v U r
tette	" t e t
kommä	k O $ " " m E:
sidona	" " s i: $ d U $ n a
brmsyka	b e r m $ s Y $ k a
gär	" " j E: r
tängt	" t e N t
konn	" k O n
cho	" s' O
ljåm	" l O m
kiill	" k i: l
jåha	" j o: $ h a
bäbisa	" b E: $ b I $ s a
äppax	e $ p a k s
thelef	t e $ " l e: v
tjåffa	" s' O $ f a
hödet	" " h 2: $ d e t
tret	" " t r e: $ % t e:
mhmm	m m
sääns	" s E:
tsässen	" t s e $ s e n
jix	" j I k s
båttet	" " b o: t $ t e t
engme	" e N $ m
numma	" n U $ m a
åtegått	" " o: $ t e $ % g O t
aschtåong	" " a s` $ % t` O $ " O N
ine	" i: $ n e
motedopp	" " m u: $ t e $ % d O p
mitchumma	" m I t s' u0 $ m a
gyckbuss	" j Y k $ % b u0 s
kasti	k a $ s t I
pfåret	" " p e: $ % f o: $ r e t
ninga	" n I N $ a
moton	m U $ t U n
lgö	l j $ % 2:
gåttan	" g O $ t a n
duvve	" " d }: v $ v e
haoa	h o: $ A: $ " u: $ a
magn	" m a N n
jaej	j a $ " e j
ngn	" n u0 N n
byxona	" " b Y k $ s U $ n a
tjeu	t s' e t $ " }:
gimman	" " j I $ m a n
kerme	" k 2: r $ m e
museumet	m }: $ " " s e: $ u0 $ m e t
kängkara	" " s' e N $ % k A: $ r a
iker	" " i: $ k e r
böjax	" " b 9 j $ % a k s
saj	" " s a j
dolto	" d O l $ t U
tåm	" " t o: $ % e m
ståg	" s t o: g
dahä	d a $ h E
safi	s a $ " f i:
dåe	" " d o: $ e
osthyven	" " U s t $ % h y: $ v e n
nai	n a $ " i:
pls	p e: $ e l $ " e s
sps	e s $ p e: $ " e s
motopet	" " m u: t $ O $ p e t
jål	" j o: l
rättelite	" " r e $ t e $ % l i: $ t e
traton	t r a $ t O n
tävit	" " t E: $ v I t
estis	e $ " s t i: s
läcken	" " l e $ k e n
anina	a $ " " n i: $ n a
slan	" s l a n
gjäm	" " g l E: m
gicka	" j I $ k a
mok	" m u: k
petha	" p e: $ t a
ritit	" " r i: $ t I t
moomoor	" m u: m u: r
prunna	" " p r u0 $ n a
sänan	" s e $ n a n
tythagömma	t Y $ t a $ % j 9 $ m a
mnhnm	" e m $ e n $ " " h o: $ e n $ " e m
matter	" m a $ t e r
toko	" " t u: $ k U
jinte	" j I n $ t e
kycklinga	" " s' Y $ k l I N $ a
jada	" j A: $ d a
hadu	h a $ " d }:
bajsam	" " b a j $ s a m
thärax	" " t E: $ r a k s
haaina	" h A: i: $ n a
fånt	" f o: n t
ledopauden	" " l e: $ d U $ " p o: $ d e n
fammä	" " f a $ " " m E:
häbä	" " h E: $ % b E:
gdå	g e $ " d o:
salv	" s a l v
ennen	" e $ n e n
finnx	" " f I N k s
ihjaa	I $ " " j A:
tyta	" " t y: $ t a
bäjä	" " b e $ j E
hasla	" " h a $ s l a
hjarnerna	" " j a $ n` e $ n` a
kängd	" s' e N d
badri	" " b A: d $ r I
tyllebytta	" t Y $ l e $ % b Y $ t a
juf	" j u0 f
häfot	" " h E: $ % f u: t
mutsie	" " m }: t $ s I
chåhä	k o: $ h E
bull	b u0 l
snummå	" " s n u0 $ " " m o:
innoting	I $ n U $ t I N
dittaa	d I $ " t A:
bata	b a $ " t A:
alri	" " A: l $ r I
häeppa	" h e e $ p a
komisens	" k u: $ m I $ s e n s
soppalunch	" " s O $ p a $ % l u0 n` s`
benbuve	" " b e: n $ % b }: $ v e
traa	" " t r A:
machs	" " m a k s
grejena	" g r e $ j e $ n a
bogge	" b U $ g e
dickit	" " d I $ k I t
ingesans	I N $ e $ " s a n s
mugga	" " m u0 $ g a
hadda	" h a $ d a
peppakaker	" " p e $ p a $ " k A: $ k e r
nåk	" n o: k
ägch	e $ s`
ajna	" a j $ n a
negge	n e $ g e
draå	d r a $ " O
hatsa	" " h a t $ s a
neven	" " n e: $ v e n
lyssax	" " l Y s a k s
ithäg	i: $ t e: $ " h E: g
dji	" d i: $ d j I
feng	f e N
gisas	" g i: $ s a s
nii	n I $ " i:
ndn	e n $ " " d e: $ % e n
mafinen	m a $ f I $ n e n
gäsda	" j e s $ d a
jäkar	" " j E: $ k a r
keia	" k e $ j a
buhuhu	b U $ h U x\ }:
hängri	" " h e N $ % r i:
tjåff	" s' O f
mommaa	m O m $ m A:
myy	" m y:
intill	I n $ " t I l
blille	" b l I $ l e
nleke	" " e n $ e l e: $ k e
jammat	" " j a $ m a t
määmma	" m E: $ m a
tsota	" t s o: $ t a
pisån	" p I s $ % o: n
fsöker	e f $ % s 2: $ k e r
hålnå	" " h o: l $ n o:
fåstås	" " f o: $ % s t o: s
gränsia	" " g r e n $ s I $ a
hono	" " h u: $ n U
russkana	" " r u0 s $ % k A: $ n a
suppa	s }: $ p a
mäil	" m e $ I l
kloppa	" k l O $ p a
tholo	" " t u: $ l U
regnrålen	" " r e N n $ r o: $ l e n
åliatjålj	o: $ l I $ a t $ j O l j
äänd	E: n d
jättesten	" " j e $ t e $ % s t e: n
ååej	o: e j
jöro	" " j 2: $ r U
slugsvamp	" " s l }: g $ % s v a m p
sädat	" s e $ d a t
itla	" i: t $ l a
tiss	" t I s
hådi	h o: $ " d i:
thöät	t 9 $ " E: t
rakparaten	" " r A: k $ p a $ % r A: $ t e n
tjäär	" s' E: r
lal	" l A: l
ånis	" " o: $ n I s
gaffe	" " g a $ f e
deblaand	d e $ " b l A: $ s a n d
minimbäbis	m I $ n I $ " m b E: $ b I s
jita	" " j i: $ t a
häxer	" " h e k $ s e r
gabiella	g a $ b I $ " e $ l a
gäkaa	" g e $ k A:
idåki	" " i: d $ o: $ k I
tjåskja	" s' O s k $ j a
stångax	" " s t O N $ % a k s
bendu	b e n $ " d }:
sötte	" s 9 $ t e
fänga	" " f e N $ a
ani	" " A: $ n I
deted	d e $ " " t e d
goma	" g o: $ m a
kanka	" k a N $ k a
fötha	" " f 2: $ t a
säe	" " s E: $ e
ålj	" O l j
tockax	t O $ " k a k s
gepa	j e $ " p a
musott	m }: $ " s O t
haffe	" h a $ f e
hässää	h e $ s E:
ranga	" " r a N $ a
meth	" m e t
tannkaka	t a N $ % k A: $ k a
mäpen	" m E: $ p e n
fepån	f e $ " p o: n
kfytha	s' I $ l U $ " f y: $ t a
afför	a $ " f 2: r
mpona	e m $ p U $ n a
sässe	" s e $ s e
mian	m I $ a n
fini	" " f i: $ n I
jäntax	" " j e n t $ % a k s
fäsicke	f e $ " s I $ k e
däkaa	" " d E: $ k A:
tkå	t e: $ k o:
gräve	" g r E: $ v e
peksinget	p e k $ s I N $ e t
dläkam	d e $ s I $ " l E: $ k a m
skruvmejs	" " s k r }: v $ % m e j s
tehat	" " t e: $ % h A: t
äsan	E: $ s a n
moth	" m O t
åäe	O E: $ e
toke	" t u: $ k e
elefantena	e $ l e $ " f a n $ t e $ n a
jomo	" j u: $ m U
lejonbarnet	" " l e $ j O n $ % b A: $ n` e t
månä	m O $ " n E:
tchillaa	" t` s` I $ l A:
nääjä	" n E: j E
fredre	f r e: $ d r e
korbit	" " k u: r $ % b i: t
lättelångt	" " l e $ t e $ % l O N t
este	" e $ s t e
skrumejker	" s k r u0 $ m e j $ k e r
smögåsbit	" s m 2: $ g o: s $ % b i: t
daaa	" d A: $ a
fååt	" f o: t
jhm	" j m
tålj	" t o: l j
dlit	d e $ s I $ " l i: t
jättemytit	" " j e $ t e $ % m y: $ t I t
cleo	" " k l e: $ U
tsat	t s a t
nyckla	" " n Y $ k l a
tätopeväv	" " t E: t $ U $ p e $ % v E: v
dtj	d s'
ädd	e d
hnktinu	N k t $ I $ n u0
hopslaga	" " h u: p $ % s l A: $ g a
assasyda	a $ s a $ " " s y: $ d a
thecka	t e $ k a
hellegg	" " h e l $ % e g
hemputen	" " h e m $ p u0 $ t e n
gäge	" j E: $ g e
puppä	" " p u0 $ p E
maskoblad	m a $ s k U $ % b l A: d
ängma	" e N $ m a
tummaa	" " t u0 m $ m A:
hain	h a $ " i: n
tötta	" " t 9 $ t a
trumpo	" " t r u0 m $ p U
skruvana	" " s k r }: $ v a $ n a
ptsi	p e: $ t e: $ e s $ " i:
tane	" t e j n
sagaa	" " s A: $ g a $ a
thäk	" " t E: k
uaaj	}: $ " " a j
köör	" s' 2: r
ots	U t s
doretset	" d u: $ r e t $ s e t
sädax	" " s E: d $ % a k s
smye	s m y: $ e
ycke	" " Y $ k e
innä	I $ " " n E:
kmein	s' i: $ l U $ " m e j n
njacka	e n $ % j a $ k a
litax	l I $ " t a k s
tedar	" " t e: $ % d a r
mammet	" " m a $ m e t
dengdä	" d e N $ d E
geggamoj	" " g e $ g a $ % m O j
käkaka	" " s' E: $ k a $ k a
påä	" " p o: $ % E:
prma	" " p e: $ e r $ m a
chiboa	s' I $ " b u: $ a
buppö	" b u0 $ " p 2:
näij	" n e j
puet	p }: $ e t
nådåj	" " n o: $ d O j
etar	e $ t a r
sylle	" s Y $ l e
dättä	" d e $ t E
hejt	" h e j t
äthe	" E: $ t e
fesiktit	f e $ " s I g $ t I t
jinner	" j I $ n e r
bich	" b I t s'
bandspelarn	" " b a n d $ % s p e: $ l a n`
farmoj	" " f a r $ % m O j
ovva	" " u: $ v e: $ v a
höts	" h 2: t s
svonnen	" s v O $ n e n
nel	n e l
silm	" " s I l m
metha	" m e: $ t a
tjånge	" s' O N $ e
dappa	" d a $ p a
chani	x\ a $ " n i:
chlutax	k l U $ " t a k s
gäskippa	" " j e $ s k I $ p a
durt	" " d u0 t`
nethåt	" n e t o: t
igå	I $ " g o:
saff	" s a f
ågg	o: g
älnanna	" e l $ " n a $ n a
krnypp	" k u0 $ n` Y $ p
häämst	" " h E: m s t
äsj	E: s`
dletta	d e $ s I $ " l e $ t a
stolebossan	s t O $ l e $ " b O $ s a n
dockebebisen	" " d O $ k e $ " b E: $ b I $ s e n
räcetebi	r e $ " s e: $ t e $ b i:
skåpe	" s k o: $ p e
danskungen	" " d a n s $ % k u0 N $ e n
hälklebyx	" " h e l $ k l e $ " b Y k s
heana	h e $ " a $ n a
öyt	9 y: t
dappax	" d a $ p a k s
ölt	9 l t
nägg	" n e g
bantoppen	" " b A: n $ % t O $ p e n
jåj	" j O j
påås	" p o: s
fälila	" " f E: $ % l i: $ l a
kottene	" " k O $ t e $ n e
tikell	t I $ " k e l
bätä	" " b E: $ t E
thlickor	t $ l I $ k U r
räcerbilana	r e $ " s e r $ b I $ % l A: $ n a
haddaa	h a $ " d A:
mjilla	" m j I $ l a
indovera	I n $ d U $ " v e: $ r a
köde	" " k 2: $ d e
gottkärran	" " g O t $ % s' e $ r a n
gch	g s`
kiax	" " s' i: $ % a k s
ååka	" " o: $ % o: $ k a
åb	o: b
knatax	" " k n A: $ t a k s
hinga	" h I N $ a
sissarna	" s I $ s a $ n` a
mammal	m a $ " m A: l
aschå	" " a s` $ % o:
tättax	" " t E: t $ % t a k s
vaff	v a $ " f
lutta	" " l u0 $ t a
noä	" n O E
uskede	}: $ % x\ e: $ d e
grätst	" g r E: t s t
jake	" j A: $ k e
användex	" " a n $ % v e n $ d e k s
bjenkan	b j e N $ k a n
hamnet	" h a m $ n e t
hanlaa	" " h A: n $ l A:
hälda	" " h e l $ d a
ahi	" A: $ h I
tået	" " t o: $ e t
koom	" " k u: m
ninnä	n I $ " n E:
flicko	" " f l I $ k U
dma	d e: $ m a
snuddax	" " s n u0 $ d a k s
siklett	" " s i: k $ % l e t
uggladokto	" " u0 $ g l a $ d O k $ t U
talemel	" " t A: $ l e $ % m e l
delind	d e $ l I n d
teis	t e $ " i: s
pit	" p I t
åegg	O $ % e g
tofflerena	" " t O $ f l e $ r e $ n a
bääbi	" " b E: $ b I
lakax	l a $ " k a k s
ducke	" " d u0 $ k e
nåns	" n O n s
båtse	" " b o: t $ % s e:
umnä	U m $ " n E:
kotanalotsn	" " k u: $ t a $ % n A: $ l U t $ s n
tannsräm	t a $ " n s $ r e m
mötse	" m 9 t $ s e
ajsat	" a j $ s a t
kickax	" " k I $ k a k s
gegä	j e $ " " g E:
tbakaa	t I $ " b e j $ k A:
tappackboo	" " t a $ p a k $ " b u:
öppal	% 9 p $ A: l
fiskax	" " f I s k $ % a k s
kji	" s' i:
farlia	" " f A: $ l` I $ a
näåe	n e $ " o: $ e
komflax	k O m $ f l a k s
jätteto	" " j e $ t e $ % t O
pottegal	" " p O $ t e $ g a l
stagi	s t a $ " g i:
häds	" " h E: d s
poten	p U $ t e n
fygpane	" f y: g $ p a $ n e
fågelen	" " f o: $ g e l $ e n
åssasgytlapp	O $ s a s $ j y: t $ % l a p
apå	a $ " p o:
nigelkotten	" " n i: $ g e l $ % k O $ t e n
snaik	" s n a j k
bujk	b u0 $ j i: $ % k o:
hmmmm	" h u0 m n m
inkf	I N $ k o: $ " e f
thidit	t I $ " d i: t
öss	9 s
tässe	" t e $ s e
pepparkake	" " p e $ p a r $ % k A: $ k e
tjaan	" s' a n
jaam	" " j A: $ a m
sabe	" s A: $ b e
blåå	" " b l o: $ % o:
äblydd	" E: $ b l Y d
öveglait	" " 2: $ v e $ % g l E
aoj	a $ " " O j
pappappa	" " p a $ p a $ p a
busters	" b u0 $ s t e s`
tatid	t a $ " t i: d
glase	" g l A: $ s e
säa	" " s E: $ a
nästat	" " n e $ s t a t
toset	" " t O $ s e t
nengax	n e N $ % a k s
butta	" " b u0 $ t a
balj	" " b a l j
näm	" n e m
tatton	" " t a $ t O n
gakla	g a $ k l a
pycke	" p Y $ k e
uckae	" " u0 $ k a $ e
tjover	" s' o: $ v e r
icheberg	I $ " s' e $ " b e r j
rigge	" r I $ g e
polla	" " p O $ l a
tenk	t e N k
padeja	p a $ " " d e $ j a
ngnag	e n $ " g n A: g
beö	" " b e: $ % 2:
paoboy	" p a*U $ b O j
jagiia	" " j A: g $ i: $ a
boand	" " b u: $ % a n d
tsiä	" " t e: $ % x\ E
klika	k l I $ k a
nani	n a $ " n i:
plussla	" " p l u0 $ s l a
ostn	U s t $ n
psätta	p s e $ t a
bmum	b e: $ e m $ " " }: $ % e m
kette	" k e $ t e
usi	}: $ e s $ " i:
oke	" u: $ k e
kickaa	" " k I $ k a $ a
tackete	" t a $ k e $ t e
jättemyck	" " j e $ t e $ % m Y $ % k
åeon	o: $ O n
fåge	" " f o: $ g e
vannbil	" v a n $ % b i: l
nappfasfa	" " n a p $ % f A: s $ f a
doff	" d O f
däg	" " d e g
thuva	" " t }: $ v a
cylla	s Y $ l a
thuvarna	" " t }: $ v a $ n` a
bomman	" " b U $ m a n
törragömma	" " t 9 $ r a $ " " j 9 $ m a
klossosso	" k l O $ s U $ s U
timh	" t E: m
vacket	" v a $ k e t
brmb	b r m b
priil	p r i: $ " " i: l
bejbibsar	" b e j $ b I b $ s a r
spele	" s p e: $ l e
chäda	k E: $ d a
obbar	" O $ b a r
nysjm	n y: $ " s` m
bafa	b a $ f a
tstädet	" " t e: $ % s t E: $ d e t
kackaa	k a $ k a $ " A:
diada	d i: $ a $ " d a
khar	k a r
dodee	d O $ d e $ e
säjet	" s e $ j e t
kytte	" " s' Y $ t e
stäe	" " s t E: $ e
badkake	" " b A: d $ % k A: $ k e
sige	s I $ g e
sööst	" s 2: s t
gönt	" j 2: n t
tockä	t O $ " k E
flill	" " f l I l
fjelia	" " f j e: $ l I $ a
thappe	" t a $ p e
thiis	" " t i: $ % i: s
pattegal	" " p a $ t e $ g a l
gjoge	" j u: $ g e
nickö	" " n I k $ % 2:
hodä	" h O t E
jättevassa	" " j e $ t e $ % v a $ s a
nånasch	" n O n a s`
fåtheh	" f o: d e
ecka	e $ k a
memme	m e $ m e
mändiforna	" m e n $ " d i: f U $ n` a
fyplan	" " f y: $ % p l A: n
chero	s' e $ r O
straand	s t r a $ % a n d
deden	" d e: $ d e n
mnaa	m n A:
gaufal	g O $ " f A: l
vlo	" " v e: $ e l $ " u:
håsten	" " h o: $ s t e: n
multon	" " m u0 l $ t O n
vunnt	v u0 n t
ånn	O n
krot	" k r u: t
jordgubb	" " j u: d` $ g u0 b
gax	" g a k s
pchäng	p e: $ s e: $ " h e N
kett	" k e t
thättemycke	t e: $ h e $ t e $ % m Y $ k e
åvauff	" " o: $ v a*U f
gåfpi	g o: $ " " e f $ p I
jättehåt	" " j e $ t e $ % h o: t
nejli	" " n e j $ l I
ntj	e n $ s'
sjävv	x\ e $ v
gerax	" j E: $ r a k s
blassbila	" b l a s $ b I $ l a
honde	h O n $ d e
minnä	m I $ " n E:
denl	d e n $ " e l
kios	" " s' O s
okroto	" " u: $ k r O $ t U
smössa	" " s m 9 $ s a
äck	e k
gulde	" g u0 l $ d e
gei	" g e j
stövlana	s t 9 v $ " l A: $ n a
ebble	" " e $ b l e
skoge	" " s k u: $ g e
tittla	" " t I t $ l a
tabost	t A: $ b O s t
kecke	" k e $ k e
chider	" s' i: $ d e r
geli	j e $ " l i:
thladdmamma	t l a d $ % m a $ m a
saja	s a $ j a
ingeti	I N $ " g e: $ t I
tolä	t O $ l E
sicho	s I $ k U
pratax	" " p r A: t $ % a k s
vääck	" v E: k
dömma	" d 9 $ m a
pindan	" " p I n $ d a n
ndemii	e n $ d e $ m I
chunge	" s' a n s'
uffö	" u0 f $ % 2:
bananena	b a $ " n A: $ n e $ n a
bäs	" " b e s
chuö	" s' a 2:
visippor	" " v i: $ % s I $ p U r
määj	" m E: j
mänsoa	" " m e $ n I $ s U $ a
stumpisar	" " s t u0 m $ p I $ s a r
lillak	" " l I $ % l a k
meax	m e $ " a k s
home	h U $ m e
räddax	" " r e $ d a k s
köpsbär	" " s' 2: p s $ b E: r
lääks	" l e E: k s
mdang	m I l $ " j A: $ d` a N
thlass	t l a s
näjnä	" n e j $ n E:
esje	" " e s $ j e
snn	e s $ e n $ " e n
thappa	" t a $ p a
thingelädjuj	" " t I N $ e $ l e j u0 j
tsöra	" t s 2: $ r a
batra	b a $ t r a
sux	" s u0 k s
fauva	f O $ v a
chåll	" " s e: $ % h O l
tfem	t e $ l e $ " f e m
chevl	x\ e v l
hie	h I $ e
tjasse	" s' a $ s e
hächen	" " h e $ s` e n
mästana	" " m e $ s t a $ n a
ththätt	t t $ h e t
lytar	" " l y: $ t a r
aej	a $ " e j
demmesdes	d e $ " m e: s $ d e s
ebis	e $ b I s
regnit	" " r e N $ n I t
thättefarlit	t e: $ h e $ t e $ f a $ l` i: t
ännetont	e $ n e $ " t o: n t
pegar	p e $ " g A: r
verp	" v e r p
kächie	" " s' e s` I $ e
fönste	" " f 9 n $ s t e
tjöbe	" s' 2: $ b e
boppo	" " b O $ p O
haddes	" h a $ d e s
manta	" " m a n $ % t A:
poj	" " p O j
nad	" " n a d
nelke	" n e l $ k e
miänna	m I $ e $ n a
kin	" k i: n
choj	" s' O j
trollkar	" " t r O l $ % k A: r
bani	" " b A: $ n I
smygi	" " s m Y $ g I
däsin	" " d E: $ s I n
tannläkan	t a n $ l E: $ k a n
ptöje	p e: $ t 9 $ j e
pastbunde	p a s t $ % b u0 n $ d e
hemlisar	" " h e m $ % l i: $ s a r
skider	" " x\ i: $ d e r
tächoperä	" t e x\ U $ p e $ r E
grise	" " g r i: s
bostää	" " b u: $ % s t E:
onga	O N $ g a
akaka	a $ " " k A: $ k a
såk	s o: $ " k o:
lillä	" l I $ l E
brä	" b r E:
venne	" " v e $ n e
iu	i: $ " }:
glepp	" g l e p
pussle	" p u0 $ s l e
singe	" s I N $ e
trååringana	" t r o: I N $ g a $ n a
bompebuss	b O m $ p e $ % b u0 s
kramax	" " k r A: m $ % a k s
tippans	" " t I $ p a n s
dre	" d r e
lgössel	e l $ j 9 $ s e l
ejaj	" " e $ j a j
vata	" " v A: $ t a
nättaa	" " n E: t $ % t A:
läva	" " l E: $ v a
mammaj	m a $ " m a j
göja	" " j 9 $ j a
hemlis	" " h e m $ % l i: s
tianger	t I $ " a N $ e r
säåck	" s e O k
arsch	" " a $ s`
bäpe	" " b E: $ p e
dasch	" " d a s`
kissekatte	k I $ s e $ " k a $ t e
muäh	" m Y E:
pygge	" p Y $ g e
gåke	" " g o: $ k e
vappä	" v a $ p E
mammer	" " m a $ m e r
tsatar	" t s A: $ t a r
lyf	" l y: f
jaamt	" " j A: $ a m t
oo	" o:
gofl	g O $ " " f l
grera	" " g r e: $ r a
denk	" d e N k
makaronena	m a $ k a $ " r u: $ n e $ n a
thöia	t 9 $ a
hääste	" " h E: s t
kaffetoppen	" " k a $ f e $ % t O $ p e n
dumpe	" " d u0 m $ p e
stallg	" " s t a l $ % j
trampetraktor	" t r a m $ p e $ % t r a k $ t U r
psove	p s U $ v e
pleis	p l e: $ i: s
höbalarnapressarna	" " h 2: $ % b A: $ l a $ n` a $ % p r e $ s a $ n` a
ningenting	" n I N $ e n $ " t I N
äkaa	e $ k A:
åhåljä	" " o: $ " h o: l $ j E
thå	" " t o:
jänte	" " j e n $ t e
dlja	" " d e: $ e l $ j a
deäbå	d e $ E: $ b o:
pöck	" p 9 k
tätte	" " t e $ t e
sittus	s I $ " t }: s
hovklaga	" " h o: v $ k l A: $ g a
beträ	b e $ " t r E:
muå	m u0 $ % o:
åmmat	O $ m a t
käckat	" " s' e $ k a t
stao	" " s t A: $ U
dlöö	d e $ s I $ " l 2:
dapax	d a $ " p a k s
ekorrje	" " e $ k O r $ j e
degbunke	" " d e: g $ % b u0 N $ k e
eigö	" e j $ g 2:
konsi	k O n $ s I
badka	" " b A: d $ k A:
rödopp	" " r 2: $ % d O p
muk	m u0 $ " k o:
mimmime	" " m I $ m I m
finane	f I $ " " n a n
duea	d }: $ " " e: $ % A:
chyga	x\ y: $ g a
tittal	t I $ " t A: l
juttifem	" " j u0 $ t I $ " f e m
hmmm	" h u0 m m
ickan	I $ k a n
ädj	" E: j
tånn	" " t O $ n
mimiin	" m i: $ m I $ I n
toml	t O m $ " e l
conelias	k O $ " n e: $ l I $ a s
gräst	" " g r e s t
reng	" r e N
neivä	" n e j $ v E
vegen	" " v e: $ g e n
boma	" " b u: $ m a
slangt	" s l a N t
ri	" r i:
ot	O t
gloga	" " g l u: $ g a
skäu	" " x\ e U
suff	s u0 $ " f
öi	" " 2: $ I
fönset	" " f 9 n $ s e t
dösa	" " d 2: $ s a
hmma	h $ m a
tote	t u: $ t e
väppa	" " v e $ p a
miao	" m j a*U
jämma	" j e $ m a
klossnade	" k l O $ s n a $ d e
haå	" " h A: $ % o:
båsa	" b o: $ s a
keen	" k i: n
kyckle	" " k Y $ k l e
kajater	k a $ " j A: $ t e r
kchi	" " s' i: $ l U $ k I
pricki	" " p r I $ k I
datsa	" d a t $ s a
sitis	" " s i: $ t I s
oåff	" " u: $ o: $ % f
thullax	t u0 $ " l a k s
hönökaka	" " h 2: $ % n 2: $ % k A: $ k a
hybe	h Y $ b e
södsgatan	" " s 2: d s $ % g A: $ t a n
äppl	e $ p e l
hännänänä	" h e $ n e $ n e $ n E:
obba	" O $ b a
munnem	" m u0 $ n e m
heoa	h e $ U $ a
pingboje	p I N $ " " b O $ j e
elä	e $ l E
bilx	b I l $ " e k s
sålj	" s O l j
handgö	" " h a n d $ j 2:
göck	" " j 9 k
schj	x\
ujö	" u0 j 2:
jättea	" " j e $ t e $ a
ekaj	e $ " k a j
haax	" " h A: $ % a k s
kyck	" k Y k
väskana	" " v e $ s k a $ n a
hanch	" h a N $ k
lässe	" " l E: s $ s e
lälte	" l e l $ t e
granfram	" " g r A: n $ % f r a m
jätteblöta	" " j e $ t e $ % b l 2: $ t a
äll	e l
soba	" s o: $ b a
fåglen	" " f o: $ g l e n
besamma	b e $ " s a $ m a
dägje	" " d e g $ j e
niinna	" " n i: $ I $ n a
mmo	e m $ m u:
bummanagn	" b u0 $ " " m e $ n I t n
hmda	" h u0 m $ d a
bebä	b e $ " b E:
mölton	" m 9 l $ t O n
blena	b l e $ n a
momö	m U $ " m 2:
majvje	" m a j $ v e: $ j e
stin	" " s t I n
mosja	m O $ s` a
köttfässås	" " s' 9 t $ f e s $ % o: s
pappö	" " p a p $ % 2:
ien	I $ e n
åjdas	O j $ d a s
tach	t a $ k
dapar	d A: $ p a r
ege	" " e: $ g e
ätn	" E: t $ n
sata	" " s A: $ t a
ställeit	" " s t e $ l e j t
jeala	x\ a $ l a
suut	" s }: t
beil	" b e j l
egenhandduk	" " e: $ g e n $ h a n d $ % d }: k
ningen	" n I N $ e n
naninerna	n a $ " n i: $ n e $ n` a
lulafton	" " l }: l $ % a f $ t O n
bröbet	" " b r 2: $ b e t
meet	m e $ e t
puumma	" p }: $ m $ m a
däsj	" " d E: s`
tankäm	" " t a N k $ e m
sosett	s U $ % s e t
räknax	" " r E: $ k n a k s
däbba	" d e $ b a
åkax	" " o: $ k a k s
trees	" t r e: $ e s
betso	" " b e t $ s O
mel	" m e l
anr	A: $ e n $ " e r
håss	h O s
hanv	h a n $ " v e:
tsittax	" t s I $ t a k s
håka	h o: $ k a
raml	" " r A: m $ l
naan	" n A: n
gucke	" " g u0 $ k e
icken	" " I $ k e n
bikuvan	" " b i: $ % k }: $ v a n
sips	" s I p s
numbe	n u0 m $ b e
tsår	" " t e: $ % s o: r
thryck	" t r Y k
pusi	" p u: $ s I
olran	" O l $ r a n
påds	" p o: d s
liffö	" " l I f $ 2:
ekorra	" " e $ k O $ r a
heej	h e $ " e j
psänge	p s e N $ e
hänä	h e $ " n E:
helda	" " h e: l $ d a
hushålsosten	" " h }: s $ h o: l s $ % U $ s t e n
pordet	" p u: $ d` e t
neklo	n e $ " k l o:
hovslaga	" " h u: v $ s l A: $ g a
ijacka	" " i: $ % j a $ k a
thår	" " t o: r
fäd	" f E: d
hönona	" " h 2: $ n U $ n a
hehähä	h e $ " h e $ h E
mödö	" " m 2: $ % d 2:
fäa	" " f E: $ a
thött	t 9 t
bije	b I $ j e
gf	" " g e: $ % e f
höh	" " h 2: $ % h o:
amlax	a m $ " l a k s
overåll	u: $ v e r $ " " O l
gånn	g o: $ " " n
pipii	" " p i: $ p I
sapar	" s A: $ p a r
vgga	" " v e: $ % g e: $ g e: $ " A:
auv	" a*U $ v
kabba	k a $ b a
sete	" s e $ t e
tillka	" " t I l $ k a
sebassur	s e $ b a $ " s }: r
supperax	s }: $ p e $ r a k s
tjövöf	" s' 2: f 2: v
vaha	v a $ " h A:
mammam	m a $ " m A: m
fägge	" " f e $ g e
nld	" " e n $ e l d
mammamammm	" " m a $ m a $ % m a $ m
tårka	" " t o: r $ k a
ajö	a $ x\ 2:
tstoffer	" t s t O $ f e r
byggit	" " b Y g $ I t
iche	I s`
lillepo	" " l I $ l e $ % p O
kjani	" s' $ n I
snablen	" " s n A: $ b l e n
nahähä	n a $ " h e $ h E
then	t e n
mnamma	" " e m $ % n a $ m a
lyssan	" " l Y $ s a n
tollet	" " t O $ l e t
dessekatte	" d e $ s e $ " k a $ t e
häter	" " h E: $ t e r
mommi	m U $ m I
stoffe	" s t O $ f e
momoumma	m U $ " m U $ m a
kostkä	" " k O s t $ s' E:
bitaj	b I $ " t a j
fyllte	" " f Y l $ t e
dolvet	" d O l $ v e t
häna	" " h E: $ n a
nickan	" " n I $ k a n
stolena	" s t u: $ l e $ n a
bröe	" " b r 2: $ e
taak	" t A: k
lekplatse	" " l e: k $ % p l a t $ s e
tdöök	" " t e: $ % d 2: k
äut	O j
tjlng	" s' N
tomteli	" " t O m $ t e $ l i:
maam	m a m
kiätta	" " s' i: $ % e $ t a
rolera	r U $ " l e: $ r a
flypl	" " f l y: $ % p l
tjissa	" s' I $ s a
thinglaar	" " t I N $ l A: r
gålle	" g O $ l e
butä	b U $ t E
tasich	t a $ " s I s'
töfoli	" " t 9 $ o: $ l I
ljijingnena	l I I N $ n e $ n a
suk	" " s }: k
tholiga	" " t u: $ l I $ g a
tarabam	" " t A: $ r a $ b a m
tjyva	" " s' y: $ v a
låssaskappana	" " l O $ s a s $ k a $ p a $ n a
kulling	" " k u0 $ l I N
but	" b }: t
gåckä	" " g O k E
tallarek	t a $ " l A: $ r e k
målarfärgburken	" " m o: $ l a r $ % f e r j $ % b u0 r $ k e n
nelrä	" n e l $ r E
ninte	n I n $ t e
tjåpp	" s' O p
bäbu	" b E: $ b }:
nake	" " n A: $ k e
nittä	n I $ t E
gävä	" " j E: $ v E
saaaps	" s A: A: p s
åvej	" " o: $ v e j
vele	" v e $ l e
fågela	" " f o: $ g e l $ % A:
giftas	" " j I f $ t a s
tjäck	" s' e k
höjk	" " h 9 j $ % k o:
siadasrummet	" " s i: $ a $ d a s $ % r u0 $ m e t
kås	" k o: s
dräve	d r e $ v e
skräckelit	" " s k r e k $ e $ % l i: t
atlea	a t $ " l e: $ a
jäka	" " j E: $ k a
ndlläää	n $ l E: E
sönkax	" " s 9 n $ k a k s
bräddrar	" " b r e $ d r a r
farbron	" " f A: r $ % b r u: n
fsil	f $ s I l
ääja	E: I $ a
ginta	" j I n $ t a
leket	" " l e: $ k e t
hästaa	" " h e s t $ % A: $ a
viseberg	" " v i: $ s e $ " b e r j
därfö	" " d E: r $ % f 9
villä	v I $ l E
föken	" " f 2: $ k e n
ejaa	e $ " " j A:
gåsse	" g O $ s e
ätte	e $ t e
kat	" k A: t
bannbile	" " b a n $ % b i: $ l e
phit	" f i: t
ponad	p U $ " n A: d
juvetompe	j }: $ " v e: $ t U m $ p e
tjuvana	" " s' }: $ % v A: $ n a
biltana	" " b i: l $ t a $ n a
däu	" d e U
vannvile	" v a n $ v i: $ l e
edag	" " e: $ % d A: g
mandarinstor	m a n $ d a $ " r i: n $ s t O r
initi	I $ n I t $ s i:
fåttar	" f O $ t a r
klote	" k l u: $ t e
mhä	e m $ h E
anneka	" " a $ n e $ k a
rapax	r a $ " p a k s
pinnenn	" " p I $ n e n
ähänge	e $ h e N $ e
säjd	" s e j d
väde	" " v E: $ d e
täbiva	" " t E: $ b i: $ v a
patana	p a $ t a $ n a
jdon	" " j i: $ % d u: n
ppdumbin	p e: $ p e: $ d u0 m $ " b i: n
tollaa	t O $ " l A:
hinta	" " h I n $ t a
blandbil	" " b l a n d $ b i: l
flypan	" " f l y: $ p a n
tänge	" " t e N $ e
dapekalle	" d e j p $ k a $ l e
hängel	" " h E: n $ % j e l
deus	" d e: $ u0 s
chöp	" x\ 2: p
galta	" " g a l $ t a
mmunk	" " e m $ % m u0 N k
uffa	" " u0 $ f a
käjä	" k e $ j E
tjålla	" s' O $ l a
vajepa	" v a $ j e $ p a
jättesjuka	" " j e $ t e $ % x\ }: $ k a
pfäthe	" f E: $ t e
spille	" s p I $ l e
fabror	f a $ b r U r
bännen	" b e $ n e n
dräja	d r e $ j a
nela	" n e $ l a
fylflygpan	" " f Y l $ f l y: g $ p a n
jmä	" " j i: $ m E
julto	" " j }: l $ t U
kaika	" k a j $ k a
sågelen	" " s o: $ g e $ l e n
jest	" j e s t
tåä	" t o: E
vapp	" v a p
schy	" x\ Y
kjom	" " s' U m
thlå	t $ l o:
sächs	s e $ " s`
baoa	" b a*U $ a
ljäka	j E: $ k a
amn	" a m n
fiksedammet	f I k $ " " s e: $ % d a $ m e t
papet	" p A: $ p e t
hågel	" " h o: $ g e l
skraka	" " s k r A: $ k a
låm	" l O m
dritax	" " d r i: $ t a k s
chumpa	" " x\ u0 m $ p a
mörktret	" " m 9 r k $ t r e t
hårnåd	" " h o: $ % n` o: d
männosan	" m e $ n U $ s a n
sanno	" " s a $ n U
fåde	" " f o: $ d e
sågelunga	" " s o: $ g e $ % l u0 N $ a
klop	" k l o: p
fabbe	" f a $ b e
kladdit	" " k l a $ d I t
hne	$ n e
cirkos	" " s I r $ k U s
choba	" " s' o: $ b a
jåchå	" j O s` o:
tugge	" t u0 $ g e
nangn	" n a N n
ginnen	" j I $ n e n
pannen	" " p a $ n e n
ninnas	" " n I $ n a s
jajaj	" " j a $ j a j
kjåckaax	" " s' O $ k a $ % a k s
holech	" h u: $ l e k
tei	" t e j
lolt	" " l O l t
varvt	" " v a r v $ t
bubbe	" b u0 $ b e
gjehuvu	" " j e $ h }: $ v u0
tadde	t a $ d e
nickax	" " n I k $ % a k s
åvapå	" " o: $ v A: $ p o:
liggee	" " l I g $ i:
sickit	" " s I $ k I t
slitslubba	" " s l i: t $ % s l u0 $ b a
lammaax	" " l a $ m a $ % a k s
garasj	g a $ " r A: s`
hita	" " h I $ t a
ååt	o: t
kfemme	k o: $ e f a m
flygplå	" " f l y: g $ p l o:
däite	" d e j $ t e
klippx	" " k l I $ p e k s
håsnoddar	" h o: $ s n U $ d a r
storare	" " s t u: $ r a $ r e
gep	j e $ " p e:
gibba	" g I $ b a
tjai	" s' a j
tarning	" " t A: $ n` I N
thecketo	t e $ k e $ t O
tallrike	" " t a l $ % r i: $ k e
jåmmax	" j O $ m a k s
dåckä	" " d O k E
ije	I $ j e
tjyke	" " s' y: $ k e
bovve	" " b u: v $ v e
doljet	" d O l $ j e t
åeo	O e: $ U
taet	t a $ e t
plastduken	" " p l a s t $ % d }: $ k e n
nääng	" " n e $ % e N
snäcker	" " s n e $ k e r
deppo	" " d e $ p O
dådaddl	" " d o: $ d a $ d e l
ksrycker	k o: $ e s $ % r Y $ k e r
ovov	U $ " v O v
fål	" " f o: l
tecke	" " t e $ k e
målje	" " m o: l $ j e
landellen	l a n $ " d e $ l e n
chika	x\ I $ k a
gelax	j e $ " l a k s
bödö	" " b 2: d $ % 2:
pät	" p E: t
skrumejsel	" " s k r }: $ % m e j $ s e l
dammal	" " d a m $ % m A: l
söret	" " s 2: $ r e t
hechla	" h e k l a
daka	" d A: $ k a
fökna	" " f 2: $ k n a
chlått	k l O t
kada	" " k A: $ d a
näni	" " n e $ n I
dump	" " d u0 m p
propelleren	p r U $ " " p e $ l e r $ e n
ajehehe	a $ " j e: $ e
guldthlickan	" " g u0 l d $ % t $ l I $ k a n
elefantboke	e $ l e $ " " f a n t $ b u: $ k e
dajda	" " d a j $ d a
djaa	" j A:
jep	" j e p
båss	" " b O s
hällit	" " h e $ l I t
noö	n U $ % 2:
kucka	" k u0 $ k a
lle	" l
dockaa	" " d O $ k a $ a
sisto	" " s I $ s t O
åttina	" " O $ t I $ n a
lyfka	" " l Y f $ k a
dubbe	" d u0 $ b e
essmör	" " e: s $ % s m 2: r
deu	" d j u:
sären	" " s E: $ r e n
atteglasen	a $ " t e $ % g l A: $ s e n
snum	" " s n u0 m
glassbila	" " g l a s $ % b i: $ l a
snöi	" " s n 2: $ I
håi	h o: $ " i:
åninnaot	" " o: $ n I $ n a $ U t
tathan	t a $ t a n
låssaslultomte	" " l O $ s a s $ % l }: l $ % t O m $ t e
kjek	" " s' e k
håä	h o: $ " " E:
våj	" v O j
tij	" t I j
nlamelamm	" " e n $ e l $ a m $ " l a m
tjolan	" s' o: $ l a n
samas	" s A: $ m a s
emede	e $ " " m e: $ d e
dusta	" d u0 $ s t a
hynde	" " h Y n $ d e
nunnerna	" " n u0 $ n e $ n` a
heng	" " h e N
varanra	v a $ " r A: n $ r a
perike	p e $ r I $ k e
srätet	" " e s $ e r $ % E: $ t e t
mönen	" " m 9 $ n e n
ame	" A: $ m e
siraff	s I $ " r a f
hämpe	" " h e m $ p e
möök	" m 2: k
sisse	" s I $ s e
kasj	k a $ " s`
talax	t a $ " l a k s
låssasjultomte	" " l O $ s a s $ " j }: l $ % t O m $ t e
djän	" " j E: n
haolsuka	h o: $ A: $ " u: l $ s }: $ k a
geng	" j e N
laldå	" l o: l $ d O
danna	" " d a $ n a
låssaliltomte	" " l O $ s a $ " l I l $ % t O m $ t e
säver	" " s E: $ v e r
pyttestund	" " p Y $ t e $ % s t u0 n d
antan	a n $ " t A: n
födut	" " f 2: $ d }: t
thyggsäck	t Y g $ % s e k
blåla	" " b l o: $ l a
tönnö	" " t 9 n $ % 2:
esch	" e s`
neemk	n e $ " e: $ e m $ % k o:
intää	I n $ " " t E:
äspa	e $ s p a
glaa	" g l A:
äcebil	s` $ % b i: l
giraffmamma	x\ I $ " " r a f $ % m a $ m a
biones	b i: $ U $ " n e: s
käufs	" k e $ u0 f s
jonses	" j U n $ s e s
unne	" " u0 $ n e
jättelånt	" " j e $ t e $ % l O N
nehm	" n e: m
hynd	" " h Y n d
slagi	" s l A: $ g I
spindlana	" " s p I n d $ l a $ n a
ginif	" j I $ n I f
påll	" " p O l
brevels	" b r e: $ v e l s
snubenpidepeba	" " s n }: $ b e n $ p I $ d e $ p e $ b a
floga	" f l o: $ g a
dalla	" d a $ l a
tjön	" s' 2: n
ugj	}: $ " " g l
äbmä	e b $ m E
gemma	" j e $ m a
tåmma	" " t O $ m a
bånk	" " b O N k
fågäl	" " f o: $ % j E: l
viarg	v I $ " a r j
mokcykle	" m u: k $ s Y $ k l e
theegn	" t e: $ e N n
ptå	" " p e: $ % t o:
dosar	" " d u: $ s a r
lini	" l i: $ n I
jääm	" j E: m
dennu	" " d e $ n }:
höngi	" " h 2: $ % n j i:
tychla	" t y: $ k l a
hoot	" h U t
därat	d E: r $ " A: t
döti	" " d 2: $ % t i:
nattklaska	" " n a t $ k l a $ s k a
teda	t e: $ d a
fingö	" f I N $ % 2:
vås	" v o: s
åsche	o: $ s`
chillax	" s' I $ l a k s
popekapåck	p U $ " p e: $ k A: p O k
naana	" n A: $ n a
feite	" " f e j $ t e
pålla	" " p O $ l a
hya	h y: $ a
haleich	h a $ " l e j s'
läda	" l E: $ d a
nigga	" n I $ g a
örå	" " 2: $ r o:
äu	U
kever	" " s' e: $ v e r
tait	" t a j t
öppn	% 9 p $ n
påsklilla	" " p O s k $ % l I $ l a
badocka	" " b A: d $ % O $ k a
ohojdåhåhå	U $ " h O j $ d O $ " h o: $ " h o:
behehebe	b e $ " h e: $ h e: $ b e
älleng	e $ l e N
mammi	" " m a $ m I
iä	I $ " E:
köffe	" k 9 $ f e
vägana	" " v E: $ g a $ n a
babis	" b A: $ b I s
dassike	" " d a $ s I $ k e
nåntans	" n O n $ t a n s
gåf	" " g o: $ % e f
chönas	" " s e: $ % h 2: $ n a s
tefalå	t e $ " f a $ l o:
byan	" " b y: $ a n
dot	" d o: t
vnang	" " v e: $ e n $ " a N
dessi	d e $ s I
tonne	" t O $ n e
städax	" " s t E: d $ % a k s
buskena	" " b u0 $ s k e $ n a
boö	" " b u: $ % 2:
grillax	" " g r I $ l a k s
hehehe	h e $ " h e: $ h e
sva	" s v a
babosten	" " b a b $ % U $ s t e n
regnbå	" " r e N n $ b o:
mis	" m i: s
suka	" s }: $ k a
vjix	" v j I k s
påcka	" " p O $ k a
jonaså	" " j u: $ n a $ s O
säld	" s e l d
silesempel	" " s i: $ l e s $ % s e m $ p e l
hadat	" h A: $ d a t
gyttå	" j Y $ t o:
fätt	" " f e t
dågla	" " d o: $ g l a
nds	n d s
klamma	k l a $ m a
öök	2: k
övelallt	" " 2: $ v e $ l a l t
klampax	" k l a m p $ % a k s
nejap	n e $ " j A: p
häa	" " h E: $ a
nbuggeksaps	e n $ b u0 g $ e k $ " s a p s
thappnet	" t a $ p n e t
idaag	I $ " " d A: g
dsån	" " d e: $ e s $ % o: n
dissidags	d I $ s I $ " d A: g s
gop	" " g O p
sittar	" " s I $ t a r
mommoe	m U $ " m u: $ e
kilacka	s' I $ " l a $ k a
nyta	" " n y: $ t a
hösj	" " h 9 s`
betha	" " b e: $ t a
gääkä	" j E: k E
håsnåd	" h o: $ s n o: d
naäma	n a $ E: $ m a
ojä	" " u: $ j E
panefan	p a $ " n e: $ f a n
adeas	a $ " d e: $ a s
lommi	" " l U $ m I
barbine	b a r $ " b i: $ n e
sping	" s p I N
dult	d u0 l t
ledit	l e $ " d i: t
deite	" d e j $ t e
gåi	g o: $ " i:
njähä	" n j E: $ h E
sennä	s e $ " n E:
thäppa	t e $ p a
noe	" n u:
chla	k l a
pannbilen	" " p a n $ % b i: $ l e n
tsönder	t $ s 9 n $ d e r
jaåj	j a $ " O j
tastax	t a $ " s t a k s
lagad	" " l A: $ g a d
påmpue	" " p o: $ % p j u:
soe	" s 9
vith	" " v I t
stik	" s t i: k
ybile	Y $ " b i: $ l e
nagnan	n a $ " g n a n
patådädå	p a $ s o: $ " d E: $ d O
aan	" a n
tytö	t Y $ t 9
geita	" " g e j $ t a
tied	" t I $ e: $ d e:
tsådde	" t s O $ d e
uchet	}: $ s e: $ % h e: t
ketchåp	" k e t s' o: p
sre	s r e
adsi	a t $ s I
liffe	" l I $ f e
bögö	" b 2: g 2:
mpe	e m $ p e
thuken	t u0 $ k e n
eftermidda	" " e f $ t e r $ % m I $ d a
sare	s a $ r e
stogå	" " s t u: $ % g o:
thättetor	t e: $ h e $ t e $ t O r
luci	l U t $ s' I
räko	" " r E: $ k U
glonni	" g l O $ n I
hååg	" h o: g
pelana	p e $ " l A: $ n a
glasöfogral	" " g l A: s $ 2: $ f O $ " g r A: l
fak	f a k
pyttax	" " p Y $ t a k s
semle	" " s e m $ l e
bamt	" " b a m t
åmaa	" " o: $ m A:
häfä	" " h E: $ % f E:
jättetu	" " j e $ t e $ % t u0
blaa	" " b l A:
dasja	" " d a $ s` a
also	" " A: l $ s O
estn	" e s t $ n
öch	9 s`
ämh	e m
slämmx	" " s l e $ m e k s
allees	a $ " l e: s
haml	h a m $ " e l
lvi	e l $ v I
kycklies	" " s' Y $ k l I $ e s
tininga	" " t i: $ n I N $ a
sofs	" s O f s
maadi	m a $ d I
fåtå	f O $ " t o:
åv	o: v
nf	e n $ e f
badräcken	" " b A: d $ % r e $ k e n
smojsen	" s m O j $ s e n
nhanne	e n $ h o: $ " a n
geba	" g e: $ b a
deejong	" d i: $ % j O N
såklabit	s o: $ " k l A: $ b I t
fikrus	" f I $ k r }: s
nämämänäjnä	n e $ m e $ m e $ n e j $ n E:
hafk	" " h a f $ k o:
ejdax	" " e j $ d a k s
dåg	" d o: g
oamma	" " u: $ % a $ m a
skotttj	" " s k O t $ s'
komran	" " k O m $ % r A: n
bäbisakena	" b E: $ b I $ s a $ k e $ n a
sonnen	" " s O $ n e n
enjeja	" " e: $ n j e $ j a
dischliklubben	" d I s k $ l I $ % k l u0 $ b e n
tsåål	" t s o: l
barbihästar	b a r $ b I $ % h e $ s t a r
tsin	" " t e: $ % s i: n
plattax	" " p l a t $ % a k s
tjang	" s' a N
ttjtkaa	t j t $ k a
sall	" s a l
bike	" " b i: $ k e
kässlen	" k e $ s l e n
jåe	" j o: $ e
tjubbe	s' u0 $ b e
tjas	" s' a s
thöde	t 9 $ d e
chåp	" s' o: p
längne	" " l e N $ n e
kjitte	" " s' I t
härna	" " h E: $ n` a
smei	" " s m e: $ I
kattkungen	" " k a t $ % k u0 N $ e n
tobe	" t u: $ b e
mäch	m e $ " s`
dajt	" " d a j t
skruvmejsana	" " s k r }: v $ % m e j $ s a $ n a
patarna	" " p A: $ t a $ n` a
fräsebåt	" f r E: $ s e $ % b o: t
ugch	" u0 N s`
benna	" b e $ n a
tornagne	t U $ " n` A: $ g n e
dälal	" " d E: $ l a l
mäin	m e $ " i: n
tatitte	t a t $ " " j $ t e
tiä	t I $ " E:
hååt	" h o: t
träppar	" t r e $ p a r
fackithä	" " f a k $ I t $ " h E:
båtet	" b o: $ t e t
ejk	" e j k
bajsax	" " b a j $ s a k s
ömö	9 m 2:
gikå	j I $ " k o:
fiffax	" " f I $ f a k s
lampona	" " l a m $ p U $ n a
frågela	" " f r o: $ g e $ l a
ocka	O $ k a
felispan	" f e: $ l I $ s p a n
hunki	" " h u0 N $ k I
katena	k a $ " " t e: $ n a
gadoben	g a $ d O $ b e n
jättego	" " j e $ t e $ % g u:
övö	" 2: v $ % 2:
hnis	" " h o: $ % n i: s
tottis	" t O $ t I s
thys	t Y s
gikadana	" " g i: $ k a $ " d A: $ n a
nöm	" n 9 m
gjomma	" j U $ m a
häkä	" " h e k E
sovt	" s o: f t
åjiö	" " o: $ j I $ 9
sysche	" " s Y $ s`
motsa	" " m u: t $ s a
hånnas	" " h o: n $ n a s
jommena	" j O $ m e $ n a
jeps	" j e p s
pannem	p a $ " n e: m
tiesch	" " t i: s`
kima	" k I $ m a
cykal	s Y $ " k A: l
nätä	" " n E: t $ % E:
rittia	" " r I $ t I $ a
båj	" " b O j
däva	" " d E: $ v a
lätteliten	" " l e $ t e $ % l i: $ t e n
lådo	" " l o: $ d U
dmi	d I $ " m i:
tses	" " t s e s
hom	" " h O m
thäej	" " t E: e j
pytteli	" " p Y $ t e $ % l i:
moklykle	" " m u: $ % k l y: $ k l e
dafflet	" d a $ f l e t
thosi	" t o: $ s I
kokona	" k U $ k U $ n a
famijen	f a $ m I $ j e n
boyen	" " b O $ j e n
alles	a $ l e s
tnyck	" " t e: $ % n Y k
kärdingar	" s' E: $ d` I N $ a r
hljutomte	" " h o: $ % j u0 $ % t O m $ t e
chätte	x\ e $ t e
restana	r e $ " " s t A: $ n a
färdä	" " f E: d` $ % E:
lesit	l e $ " s i: t
tjåg	" s' o: g
nami	n a $ " m i:
blytt	" " b l Y t
påppegåpp	" " p O $ p e $ % g o: p
fasspinne	" f a s $ % p I $ n e
jogubbar	" " j U $ % g u0 $ b a r
håpp	" h o: p
tebaks	t e $ " b A: k s
dockå	" " d O k $ % o:
håtta	h O $ t a
gögö	j 9 $ g 2:
smussax	" " s m u0 s $ % s a k s
gs	g s
vedar	" " v e: $ d a r
meena	" m e: $ n a
decko	" " d e $ k U
teja	t e $ j a
fje	" f j e
blilla	" b l I $ l a
sinår	" " s I n $ % o: r
juff	" j u0 f
kjoo	" " s' u:
tjåffe	" s' O $ f e
fs	f s
blukar	" " b l }: $ k a r
åsta	O $ s t a
sönä	" s 9 n $ d E
båckatj	" " b O k t s'
mappa	" " m a $ p a
låssajultomte	" " l O $ s a $ " " j }: l $ % t O m $ t e
thåat	t O $ " A: t
tjett	" s' e t
tjugge	s' u0 $ g e
tave	" " t A: $ v e
botte	" " b O $ t e
börn	" b 2: n`
dope	" d u: $ p e
llätteling	" l e $ t e $ % l I N
hänn	" h e n
ricke	" " r I $ k e
fill	" f I l
fögis	" " f 2: $ g I s
ålfon	" O l $ f O n
länkal	" " l e N k $ % A: l
häsar	" " h E: $ s a r
hässap	h e $ " " s a p
miinne	m I $ " " I $ n e
sandst	" " s a n d $ s t
setta	" " s e $ t a
sänksäklt	" s e N k $ s E: $ k l t
fummaa	" " f u0 m $ m A:
isä	I $ " " s E:
filå	" " f i: l $ % o:
äpå	E: p o:
buu	" b u:
äek	k
elj	" e l j
tampetaktor	" t a m $ p e $ " t a k $ t U r
oåssis	" " u: $ o: s $ % s i: s
halse	" h a l $ s e
rivde	" " r i: v $ d e
sra	s r a
intä	I $ n E
vatteä	" " v a $ t e $ % E:
håch	" h O x\
åeh	O e
iska	I $ s k a
glai	" " g l a $ I
slägge	" " s l e $ g e
srande	e s $ r a n $ d e
bid	" b I d
rättemjukt	" " r e $ t e $ % m j }: k t
kjiita	" s' i: $ t a
dnämdens	" d n e m $ d e n s
nge	" n e:
busitta	" " b }: $ s I $ t a
taå	" " t A: $ % o:
bååk	" b o: k
samse	" " s a m $ s e
kissekattä	k I $ s e $ " k a $ t E
trumpona	" " t r u0 m $ p U $ n a
nanen	" n A: $ n e n
underbyxer	" " u0 n $ d e r $ % b Y k $ s e r
sossa	" " s U $ s a
pel	" p e l
annaa	a $ " n A:
sempel	" s e m $ p e l
näon	" " n E: $ O n
mommoo	m U $ " m o:
änen	e $ n e n
grägopa	" " g r E: $ % g u: $ p a
bollana	" " b O $ l a $ n a
rottis	" " r O $ t I s
låssastaffe	" " l O $ s a s $ t a $ f e
hjäpe	" j E: $ p e
ujo	u0 $ j U
ninä	n I $ " " n E:
tålar	" " t o: $ l a r
prke	" " p e: $ e r $ k e
thappne	" t a p $ n e
funde	f u0 n $ d e
pambila	p a m $ " b i: $ l a
djia	d j I $ a
nones	n O $ n e s
räcerbana	r e $ " " s e: r $ % b A: $ n a
fälv	" f e l v
jagagä	" " j A: $ g a $ " " g E:
momomo	m U $ " n o: $ m U
täje	" " t e $ j e
loffet	" " l O $ f e t
baksämma	" " b A: k $ s e $ m a
syke	s Y $ k e
benbuvve	" " b e: n $ % b u0 $ v e
lejve	" l e j $ v e
thylla	t Y $ l a
ahää	" A: $ h E:
shäm	" x\ e m
flätol	" " f l E: t $ % u: l
mek	m e k
didde	d I $ d e
häää	" " h E: E
julkomt	" " j }: l $ k O m t
bäjb	" " b e $ j e $ " b e:
semn	" s e m n
ponnerna	" " p O $ n e $ n` a
randra	" r a n $ d r a
messen	" m e $ s e n
gja	g e: $ j a
motscykel	" m a $ d s $ % s Y $ k e l
pfö	" f 2:
etha	" e: $ t a
fbajsax	e f $ b a j $ s a k s
tattis	" " t a $ t I s
söre	" " s 2: $ r e
rammar	" " r a $ m a r
köthä	" " s' 9 t $ h E
nääh	" n E:
tästen	" t e $ s t e n
pulling	" p u0 $ l I N
fälie	f e $ " l i:
loll	" l O l
frutti	" " f r u0 $ t I
dåtta	d I $ " " O $ t a
lejl	" l e j l
sampa	" s a m $ p a
majn	" " m a j $ % n
tatst	t a d s t
tefåta	" " t e: $ % f o: $ t a
bledu	" " b l e: $ d e: $ " }:
sne	" s n e
thätteumlus	" " t E: $ " t e: $ u0 m $ l u0 s
aen	a $ e n
taff	" t a f
klyd	" k l y: d
mjam	" m j A: m
nanang	n a $ " n a N
solax	" " s u: $ l a k s
böaö	" " b 2: $ a $ % 2:
hamen	" h a $ m e n
nåtså	" " n o: t $ % s o:
domt	" d o: m t
papeter	p a $ " p e: $ t e r
dommi	" d O $ m I
gåa	" " g o: $ a
tråst	" t r O s t
dricke	" " d r I $ k e
blitana	b l I $ " t A: $ n a
kyckee	" " k Y $ k I
häppar	" h e $ p a r
molis	m U $ " l i: s
killebäbis	s' I $ l e $ " b E: $ b I s
huskuset	" " h }: s $ % k u0 $ s e t
sibba	" " s I $ b a
dägandäk	" " d e g e r j E: k
därt	d E: t`
gnoven	" g n o: $ v e n
mokcikle	" m u: k $ s I $ k l e
jäddis	" j e $ % d i: s
tiningen	" " t i: $ n I N $ e n
kommerea	k O $ " " m e I
morm	" m O r m
hähää	" " h e $ % h E:
tammam	" " t a m $ a m
rödmaneten	" " r 2: d $ m a $ % n e: $ t e n
mnh	m n
kommerid	k O $ m e $ " r i: d
boppaa	" " b O $ p a $ a
barbihästarna	b a r $ b I $ % h e $ s t a $ n` a
bamseelefanten	" " b a m $ s e $ e $ l e $ % f a n $ t e n
zebla	" " s e: $ b l a
lyll	" l Y l
ija	i: $ j a
slipsas	" " s l I p $ s a s
bussee	b u0 $ " " s i:
nånsti	" n O n $ s t I
jäoka	" " j E: $ % u: $ k a
famde	" " f a m $ d e
famskolare	" " f a m $ % s k u: $ l a $ r e
låte	" " l o: $ t e
hadä	h a $ " d E:
klosch	" k l O s`
dunbrö	" " d }: n $ b r 2:
luss	" " l u0 s
igenom	I $ " j e: $ n O m
banten	" b a n $ t e n
agi	a $ " g i:
jumpaskorna	" " j u0 m $ p a $ % s k u: $ n` a
halsbannet	" " h a l s $ % b a $ n e t
pei	" p e j
bossel	" b O $ s e l
ågulle	" " o: $ g u0 $ l e
gsång	g $ % s O N
pedä	p e $ " d E:
attet	" " a $ t e t
kjach	" s' a x\
tommma	" t $ m a
affå	a $ " f o:
madele	m a $ " d e l
lammä	" " l a m $ % E:
hämmaldal	" " h e $ m a l $ d A: l
tjölje	" s' 9 l $ j e
nöme	" " n 9 $ m e
byxena	" " b Y k $ s e $ n a
niau	" n j a*U
pinsessa	p I n $ " " s e $ s a
vlja	" " v e: $ e l $ j a
bia	" " b a $ j a
bandspelar	" " b a n d $ % s p e: $ l a r
hänna	" h e $ n a
tnycke	" " t e: $ % n Y $ k e
ubbla	u0 $ b l a
gaja	" " g a $ j a
kjaass	" s' a s
bamme	" b a $ m e
kån	" k o: n
ngaa	e N $ g A:
tallrä	" " t a l $ r E
paddalax	" " p a $ d a $ " l a k s
drickit	" " d r I $ k I t
åhåhå	" " o: $ h o: $ " h o:
innea	" " I $ n e $ a
hukhuset	" h }: k $ % h }: $ s e t
sonne	" s O n
spagettina	s p a $ " " g e $ t I $ n a
thättesiktit	t e: $ h e $ t e $ % s I g $ t I t
rullskriskor	" " r u0 l $ s k r I $ s k U r
cecila	s e $ " s i: $ l a
odit	" " u: $ d I t
turtles	" " t }: r $ t e l s
aav	" " o: $ % v e:
nij	" n j
thädit	" " t E: $ d I t
tjom	" s' O m
hägga	" " h e $ g a
böcka	" b 9 $ k a
traja	" t r a $ j a
ammet	a $ m e t
njo	" n j u:
hälli	" " h e $ l I
tocke	" t O $ k e
jaop	j a $ " O p
jal	" j A: l
tjgå	" s' g o:
pn	" " p e: $ % e n
äaä	E
såås	s o: $ " o: s
dung	" d u0 N
kamas	" k A: $ m a s
elpa	" " e: l $ p a
blommo	" " b l U $ m U
non	n O n
sjs	s`
spryga	" s p r y: $ g a
dsäng	" " d e: $ e s $ % e N
sräns	s r E: n s
thicket	" " t I $ k e t
såm	" s O m
äsma	e $ s m a
skitstarka	" " x\ i: t $ % s t a r $ k a
läthä	" " l e t $ h E:
elikopper	e $ l I $ " " k O $ p e r
högna	" " h 2: g $ n a
mosvå	" " m u: $ % s v o:
kunblax	" k u0 n $ b l a k s
tsitta	" " t e: $ % s I $ t a
sep	" " s e: $ % p e:
eha	e $ h a
döjja	d 9 $ j a
våå	" v o:
flug	" " f l }: g
jättelänge	" " j e $ t e $ % l e N $ e
hufä	h u0 $ " " f E:
hirap	h I $ " r a p
tåtta	" " t O $ t a
conelis	" k O n` e: $ l I s
äle	" E: $ l e
ömilda	" " 2: $ m I l $ d a
stöjle	" " s t 9 j $ l e
åtlåtta	" " O $ l` O $ t a
hällä	" " h e $ l E
deda	" d e: $ d a
görfin	" " g 2: r $ % f i: n
liti	l I $ t I
chånna	" s' O $ n a
binena	" " b i: $ % n e $ n a
tolen	" t o: $ l e n
leksasamine	" " l e: k $ s a $ s a $ " " m i: n
håmm	" h o: m
kella	" k e $ l a
boch	" " b O $ k
billa	" " b I $ l a
ruax	r u0 $ " a k s
kistoffel	" " s' I $ s t O $ f e l
åko	" " o: $ k U
gjöt	" " j 2: t
täss	" t e s
honond	h O $ n O n d
bäbispesenten	" b E: $ b I $ s p e $ % s e n $ t e n
dak	d a k
jahaa	j A: $ " h A:
rättemjuk	" " r e $ t e $ % m j }: k
äåx	O k s
ajaj	a $ x\ a j
lenube	l e: $ n u0 $ b e
happt	" h a p t
thättetjock	" " t E: t $ t e $ % s' O k
ucha	" " u0 $ s` a
klättade	" " k l e $ t a $ d e
pköt	p e: $ k o: $ " " 2: t
chmydad	x\ $ m y: $ d a d
her	h e r
millionam	m I l $ j U $ " n a m
tye	" " t y: $ e
ksicka	k $ s I $ k a
silmar	" s I l $ m a r
dävasin	" " d E: $ v a $ " s i: n
nuk	n }: $ " k o:
gek	" g e: $ k o:
fåtala	" " f o: $ % t A: $ l a
thöpa	" " t 2: $ p a
smussar	" s m u0 $ s a r
älisebile	" e l E: s $ b i: $ l e
denni	" d e $ n I
vågal	" " v o: $ g a l
tne	t $ n e
dommas	d U $ m a s
håsnodd	" h o: $ s n U d
bajsat	" " b a j $ s a t
klista	" k l I $ s t a
hättedumt	" " h e $ t e $ % d u0 m t
ichke	I k $ k e
sånga	" " s O N $ a
sja	" x\ a
idch	i: $ d e: $ " s`
däsklippa	" d E: s $ % k l I $ p a
liksom	" " l i: k $ s O m
taktoförare	" " t a k t $ u: $ % f 2: $ r a $ r e
veitol	" " v e j t u: l
bäp	" " b E: p
däbe	" " d E: $ b e
poh	" p u:
hanje	h a $ n j e
themmi	t e $ m I
jäps	" j E: p s
blätte	" " b l e $ t e
kena	k e $ n a
läjla	" l e j $ l a
näar	" " n E: $ a r
suddgumme	" " s u0 d $ % g u0 $ m e
mäst	" " m e s t
chuet	" s' u0 $ e t
ralmax	r a l $ " m a k s
grn	g e: $ e r $ " e n
eoda	e $ " o: $ d a
båpaa	" b o: $ p A:
hölot	" " h 2: $ % l u: t
thötha	t 9 $ t a
häta	" " h E: $ t a
rammat	" " r a $ m a t
tjåå	" s' o:
virax	" " v i: $ r a k s
hjälma	" " j e l $ m a
della	" " d e $ l a
slipe	" s l i: $ p e
biit	b I $ " i: t
jaf	" j A: f
marsin	m a $ " s` i: n
lullull	" l u0 l $ % u0 l
tänena	" t E: $ n e $ n a
mianga	m I $ " a N $ a
badbosten	" " b A: d $ % b O $ s t e n
döte	" " d 2: $ t e
vö	" " v 2:
snuna	" " s n }: $ n a
atin	a $ " t i: n
gråk	" g r o: k
srälla	s r e $ l a
assel	" a $ s e l
doda	d O $ d a
bassax	b a $ " s a k s
somnax	" " s O m $ n a k s
sapst	" s a p s t
aru	" " A: $ r u0
namme	" n a $ m e
meen	" m e n
blikslås	" b l i: k $ s l o: s
tokit	" " t u: $ k I t
nähe	" " n E:
talliksharvar	" t a $ l I k $ s` a r $ v a r
betho	" " b e: t $ % h u:
pippandyt	" " p I $ p a n $ d Y t
ääd	E: d
ögo	" " 2: $ g U
